id,type,master_id,prompt_tokens,completion_tokens,total_tokens,start_time,end_time,time_taken_in_seconds
1,rephrase_question,1,0,0,0,1755973990.761685,1755973990.7633283,0.0016434192657470703
2,intent_identification,1,1601,210,1811,1755973990.7648578,1755973994.6768248,3.9119670391082764
3,map_indices_to_names,1,0,0,0,1755973994.6771686,1755973994.695423,0.01825428009033203
4,sql_generation,1,639,84,723,1755973994.6976326,1755973995.95327,1.2556374073028564
5,sql_execution,1,0,0,0,1755973995.9546878,1755973997.1207669,1.166079044342041
6,rephrase_question,2,0,0,0,1755974496.78533,1755974496.7870197,0.0016896724700927734
7,intent_identification,2,1601,235,1836,1755974496.7874389,1755974500.5578635,3.7704246044158936
8,map_indices_to_names,2,0,0,0,1755974500.5584683,1755974500.5699134,0.011445045471191406
9,sql_generation,2,639,84,723,1755974500.5730724,1755974501.7271776,1.1541051864624023
10,sql_execution,2,0,0,0,1755974501.7281373,1755974502.9297845,1.2016472816467285
11,rephrase_question,3,0,0,0,1755974611.9339914,1755974611.9350185,0.0010271072387695312
12,intent_identification,3,1601,192,1793,1755974611.9353895,1755974615.191687,3.2562975883483887
13,map_indices_to_names,3,0,0,0,1755974615.1919048,1755974615.195032,0.0031270980834960938
14,sql_generation,3,639,84,723,1755974615.195728,1755974616.3978794,1.2021512985229492
15,sql_execution,3,0,0,0,1755974616.3986669,1755974617.5282469,1.129580020904541
16,rephrase_question,4,0,0,0,1756101929.366937,1756101929.3697228,0.002785921096801758
17,intent_identification,4,1601,184,1785,1756101929.370265,1756101933.1321373,3.7618722915649414
18,map_indices_to_names,4,0,0,0,1756101933.1327596,1756101933.145731,0.01297140121459961
19,sql_generation,4,639,84,723,1756101933.1462567,1756101934.306306,1.1600492000579834
20,sql_execution,4,0,0,0,1756101934.3068204,1756101935.4198248,1.113004446029663
21,rephrase_question,5,0,0,0,1756107233.294306,1756107233.296712,0.002405881881713867
22,intent_identification,5,1266,200,1466,1756107233.2968976,1756107237.0808892,3.783991575241089
23,map_indices_to_names,5,0,0,0,1756107237.0819783,1756107237.0902674,0.008289098739624023
24,sql_generation,5,909,83,992,1756107237.0909274,1756107238.5110087,1.420081377029419
25,sql_execution,5,0,0,0,1756107238.511662,1756107239.8453796,1.3337175846099854
26,rephrase_question,6,0,0,0,1756192674.7712858,1756192674.7751565,0.003870725631713867
27,intent_identification,6,1490,215,1705,1756192674.7756007,1756192677.7578464,2.982245683670044
28,map_indices_to_names,6,0,0,0,1756192677.758416,1756192677.7732382,0.014822244644165039
29,sql_generation,6,909,90,999,1756192677.773668,1756192679.575361,1.8016929626464844
30,sql_execution,6,0,0,0,1756192679.575915,1756192681.2605567,1.6846415996551514
31,rephrase_question,1,0,0,0,1756288632.8985395,1756288632.9007416,0.0022020339965820312
32,intent_identification,1,2859,304,3163,1756288632.9011261,1756288637.8141918,4.913065671920776
33,map_indices_to_names,1,0,0,0,1756288637.8148882,1756288637.8251529,0.01026463508605957
34,sql_generation,1,914,78,992,1756288637.8261197,1756288639.3576267,1.5315070152282715
35,sql_execution,1,0,0,0,1756288639.3582063,1756288639.9357214,0.5775151252746582
36,rephrase_question,1,0,0,0,1756289393.8728342,1756289393.8739367,0.001102447509765625
37,intent_identification,1,2859,299,3158,1756289393.874264,1756289397.813397,3.9391329288482666
38,map_indices_to_names,1,0,0,0,1756289397.8143072,1756289397.8198788,0.005571603775024414
39,sql_generation,1,912,88,1000,1756289397.8207135,1756289399.126039,1.3053255081176758
40,sql_execution,1,0,0,0,1756289399.1275275,1756289399.6385517,0.5110242366790771
41,rephrase_question,1,0,0,0,1756367530.7642293,1756367530.7661512,0.0019218921661376953
42,intent_identification,1,2218,247,2465,1756367530.7667003,1756367535.036348,4.269647836685181
43,map_indices_to_names,1,0,0,0,1756367535.0369658,1756367535.0488367,0.011870861053466797
44,sql_generation,1,811,132,943,1756367535.0498574,1756367536.784605,1.7347476482391357
45,sql_execution,1,0,0,0,1756367536.785501,1756367537.333842,0.5483410358428955
46,rephrase_question,1,0,0,0,1756367567.2057116,1756367567.2060747,0.0003631114959716797
47,intent_identification,1,2218,253,2471,1756367567.2063906,1756367570.274475,3.068084478378296
48,map_indices_to_names,1,0,0,0,1756367570.2751708,1756367570.2847128,0.009541988372802734
49,sql_generation,1,811,129,940,1756367570.2866163,1756367572.0116334,1.7250170707702637
50,sql_execution,1,0,0,0,1756367572.0130422,1756367572.1013012,0.08825898170471191
51,rephrase_question,1,0,0,0,1756367856.8708508,1756367856.8709695,0.00011873245239257812
52,intent_identification,1,2204,191,2395,1756367856.8710992,1756367860.4723883,3.6012890338897705
53,map_indices_to_names,1,0,0,0,1756367860.4730587,1756367860.481796,0.008737325668334961
54,sql_generation,1,786,48,834,1756367860.4827154,1756367861.8011026,1.3183872699737549
55,sql_execution,1,0,0,0,1756367861.8016727,1756367862.1982307,0.3965580463409424
56,rephrase_question,1,0,0,0,1756367949.471796,1756367949.4721086,0.00031256675720214844
57,intent_identification,1,2214,202,2416,1756367949.4725924,1756367952.113125,2.6405327320098877
58,map_indices_to_names,1,0,0,0,1756367952.1138108,1756367952.1249032,0.011092424392700195
59,sql_generation,1,807,137,944,1756367952.1262124,1756367953.8551173,1.7289049625396729
60,sql_execution,1,0,0,0,1756367953.8564982,1756367953.9393327,0.08283448219299316
61,rephrase_question,1,0,0,0,1756372038.6434453,1756372038.6437569,0.0003116130828857422
62,intent_identification,1,2214,188,2402,1756372038.6442616,1756372042.0219946,3.377732992172241
63,map_indices_to_names,1,0,0,0,1756372042.022363,1756372042.0283587,0.005995750427246094
64,sql_generation,1,807,115,922,1756372042.0291712,1756372043.5599616,1.5307903289794922
65,sql_execution,1,0,0,0,1756372043.5610583,1756372043.7053647,0.14430642127990723
66,rephrase_question,1,0,0,0,1756377969.30275,1756377969.3034446,0.0006945133209228516
67,intent_identification,1,1186,96,1282,1756377969.303743,1756377972.2080033,2.9042603969573975
68,map_indices_to_names,1,0,0,0,1756377972.2083542,1756377972.212948,0.004593849182128906
69,sql_generation,1,768,18,786,1756377972.2131202,1756377972.959869,0.746748685836792
70,sql_execution,1,0,0,0,1756377972.9605656,1756377973.6569946,0.6964290142059326
71,rephrase_question,1,0,0,0,1756378129.243331,1756378129.2436879,0.00035691261291503906
72,intent_identification,1,1186,101,1287,1756378129.2442708,1756378130.9484036,1.7041327953338623
73,map_indices_to_names,1,0,0,0,1756378130.9488878,1756378130.9564998,0.007611989974975586
74,sql_generation,1,768,18,786,1756378130.9572606,1756378131.674872,0.7176113128662109
75,sql_execution,1,0,0,0,1756378131.6754842,1756378131.7036393,0.028155088424682617
76,rephrase_question,1,0,0,0,1756380059.8530512,1756380059.8554265,0.002375364303588867
77,intent_identification,1,1183,107,1290,1756380059.8559926,1756380061.75905,1.903057336807251
78,map_indices_to_names,1,0,0,0,1756380061.7598789,1756380061.7710018,0.011122941970825195
79,sql_generation,1,768,18,786,1756380061.7718198,1756380062.4675431,0.695723295211792
80,sql_execution,1,0,0,0,1756380062.4680767,1756380062.7248163,0.25673961639404297
81,rephrase_question,1,0,0,0,1756380492.2460983,1756380492.2490215,0.002923250198364258
82,intent_identification,1,1153,127,1280,1756380492.2496665,1756380494.165489,1.9158225059509277
83,map_indices_to_names,1,0,0,0,1756380494.1659088,1756380494.1766448,0.01073598861694336
84,sql_generation,1,768,18,786,1756380494.1771922,1756380494.8955605,0.7183682918548584
85,sql_execution,1,0,0,0,1756380494.8961728,1756380495.8316026,0.9354298114776611
86,rephrase_question,1,0,0,0,1756380625.4897797,1756380625.4920316,0.002251863479614258
87,intent_identification,1,1178,99,1277,1756380625.4923823,1756380628.5290315,3.036649227142334
88,map_indices_to_names,1,0,0,0,1756380628.529831,1756380628.5424225,0.01259160041809082
89,sql_generation,1,768,17,785,1756380628.543486,1756380629.3449461,0.8014600276947021
90,sql_execution,1,0,0,0,1756380629.345853,1756380629.691514,0.345660924911499
91,rephrase_question,1,0,0,0,1756380687.0186086,1756380687.0225325,0.003923892974853516
92,intent_identification,1,1154,111,1265,1756380687.0232174,1756380690.1670127,3.1437952518463135
93,map_indices_to_names,1,0,0,0,1756380690.167699,1756380690.18321,0.015510797500610352
94,sql_generation,1,768,18,786,1756380690.1842108,1756380690.883044,0.6988332271575928
95,sql_execution,1,0,0,0,1756380690.883413,1756380691.5551116,0.6716985702514648
96,rephrase_question,1,0,0,0,1756380730.1924357,1756380730.1928592,0.000423431396484375
97,intent_identification,1,1151,109,1260,1756380730.1937802,1756380731.7330403,1.5392601490020752
98,map_indices_to_names,1,0,0,0,1756380731.733995,1756380731.7452605,0.01126551628112793
99,sql_generation,1,764,14,778,1756380731.7459812,1756380732.5622418,0.816260576248169
100,sql_execution,1,0,0,0,1756380732.563215,1756380732.7473204,0.18410539627075195
101,rephrase_question,1,0,0,0,1756380766.8618863,1756380766.8620892,0.0002028942108154297
102,intent_identification,1,1144,88,1232,1756380766.8635461,1756380768.2971323,1.4335861206054688
103,map_indices_to_names,1,0,0,0,1756380768.297621,1756380768.3083684,0.010747432708740234
104,sql_generation,1,757,14,771,1756380768.311035,1756380769.0189025,0.7078676223754883
105,sql_execution,1,0,0,0,1756380769.0200553,1756380769.1214876,0.10143232345581055
106,rephrase_question,1,0,0,0,1756380793.4964428,1756380793.4971304,0.0006875991821289062
107,intent_identification,1,1145,80,1225,1756380793.4982514,1756380794.826574,1.3283226490020752
108,map_indices_to_names,1,0,0,0,1756380794.8277662,1756380794.8443327,0.01656651496887207
109,sql_generation,1,758,18,776,1756380794.8469112,1756380795.9430115,1.0961003303527832
110,sql_execution,1,0,0,0,1756380795.943938,1756380796.091993,0.1480550765991211
111,rephrase_question,1,0,0,0,1756380812.9699957,1756380812.9703295,0.0003337860107421875
112,intent_identification,1,1155,105,1260,1756380812.9714353,1756380814.3764608,1.4050254821777344
113,map_indices_to_names,1,0,0,0,1756380814.377286,1756380814.3907814,0.013495445251464844
114,sql_generation,1,768,14,782,1756380814.394076,1756380815.195405,0.8013288974761963
115,sql_execution,1,0,0,0,1756380815.198223,1756380815.4138417,0.21561861038208008
116,rephrase_question,1,0,0,0,1756380838.4714038,1756380838.4717252,0.00032138824462890625
117,intent_identification,1,1156,128,1284,1756380838.4722228,1756380840.0770233,1.6048004627227783
118,map_indices_to_names,1,0,0,0,1756380840.0783296,1756380840.088247,0.009917497634887695
119,sql_generation,1,769,18,787,1756380840.0944314,1756380840.791663,0.6972315311431885
120,sql_execution,1,0,0,0,1756380840.7934377,1756380840.9201655,0.12672781944274902
121,rephrase_question,1,0,0,0,1756380865.3587153,1756380865.3589513,0.00023603439331054688
122,intent_identification,1,1144,101,1245,1756380865.3593075,1756380866.7647197,1.405412197113037
123,map_indices_to_names,1,0,0,0,1756380866.7653024,1756380866.7782521,0.012949705123901367
124,sql_generation,1,757,14,771,1756380866.7790823,1756380867.5203333,0.7412509918212891
125,sql_execution,1,0,0,0,1756380867.5209165,1756380867.637682,0.11676549911499023
126,rephrase_question,1,0,0,0,1756380896.5736125,1756380896.5738387,0.0002262592315673828
127,intent_identification,1,1148,101,1249,1756380896.5748255,1756380898.1486945,1.573868989944458
128,map_indices_to_names,1,0,0,0,1756380898.1501482,1756380898.1637738,0.013625621795654297
129,sql_generation,1,761,18,779,1756380898.16475,1756380898.8561337,0.6913836002349854
130,sql_execution,1,0,0,0,1756380898.8572297,1756380898.980685,0.12345528602600098
131,rephrase_question,1,0,0,0,1756380914.4042826,1756380914.4046164,0.0003337860107421875
132,intent_identification,1,1145,113,1258,1756380914.405156,1756380915.9552035,1.5500476360321045
133,map_indices_to_names,1,0,0,0,1756380915.955984,1756380915.9725378,0.016553640365600586
134,sql_generation,1,758,18,776,1756380915.9748657,1756380916.677814,0.7029483318328857
135,sql_execution,1,0,0,0,1756380916.6786127,1756380916.8088653,0.13025259971618652
136,rephrase_question,1,0,0,0,1756381088.9269302,1756381088.927222,0.0002918243408203125
137,intent_identification,1,1145,109,1254,1756381088.927638,1756381090.4428995,1.5152614116668701
138,map_indices_to_names,1,0,0,0,1756381090.4434352,1756381090.455738,0.012302875518798828
139,sql_generation,1,758,15,773,1756381090.460434,1756381091.1581604,0.6977264881134033
140,sql_execution,1,0,0,0,1756381091.1590593,1756381091.2485955,0.08953619003295898
141,rephrase_question,1,0,0,0,1756381508.7758827,1756381508.7788095,0.0029268264770507812
142,intent_identification,1,1163,124,1287,1756381508.7791538,1756381510.9908895,2.211735725402832
143,map_indices_to_names,1,0,0,0,1756381510.991547,1756381511.0017524,0.010205268859863281
144,sql_generation,1,769,18,787,1756381511.002739,1756381511.709347,0.7066080570220947
145,sql_execution,1,0,0,0,1756381511.7101805,1756381512.3319774,0.6217968463897705
146,rephrase_question,1,0,0,0,1756381603.8987556,1756381603.8988795,0.0001239776611328125
147,intent_identification,1,1152,111,1263,1756381603.8991656,1756381605.403146,1.5039803981781006
148,map_indices_to_names,1,0,0,0,1756381605.4037874,1756381605.4152715,0.011484146118164062
149,sql_generation,1,759,18,777,1756381605.4159946,1756381606.062378,0.6463832855224609
150,sql_execution,1,0,0,0,1756381606.0632389,1756381606.144996,0.0817570686340332
151,rephrase_question,1,0,0,0,1756381672.8428574,1756381672.8433456,0.00048828125
152,intent_identification,1,1152,118,1270,1756381672.8455763,1756381674.6516762,1.8060998916625977
153,map_indices_to_names,1,0,0,0,1756381674.652136,1756381674.6633873,0.011251211166381836
154,sql_generation,1,759,18,777,1756381674.667232,1756381675.3769548,0.7097227573394775
155,sql_execution,1,0,0,0,1756381675.3776681,1756381675.494845,0.11717677116394043
156,rephrase_question,1,0,0,0,1756381705.5908282,1756381705.5929916,0.002163410186767578
157,intent_identification,1,1152,99,1251,1756381705.593548,1756381707.2569723,1.6634242534637451
158,map_indices_to_names,1,0,0,0,1756381707.2578948,1756381707.2834802,0.025585412979125977
159,sql_generation,1,759,18,777,1756381707.2864182,1756381708.0067096,0.7202913761138916
160,sql_execution,1,0,0,0,1756381708.0077715,1756381708.4369633,0.42919182777404785
161,rephrase_question,1,0,0,0,1756381880.7091029,1756381880.709328,0.000225067138671875
162,intent_identification,1,1167,118,1285,1756381880.7095783,1756381882.2902138,1.5806355476379395
163,map_indices_to_names,1,0,0,0,1756381882.2909038,1756381882.2986271,0.007723331451416016
164,sql_generation,1,759,18,777,1756381882.2991447,1756381883.2111177,0.9119729995727539
165,sql_execution,1,0,0,0,1756381883.2116385,1756381883.2932763,0.08163785934448242
166,rephrase_question,1,0,0,0,1756381910.5911114,1756381910.5916102,0.0004987716674804688
167,intent_identification,1,1152,156,1308,1756381910.5919132,1756381912.3961816,1.8042683601379395
168,map_indices_to_names,1,0,0,0,1756381912.3965645,1756381912.4039383,0.007373809814453125
169,sql_generation,1,759,18,777,1756381912.4045413,1756381913.2120442,0.8075029850006104
170,sql_execution,1,0,0,0,1756381913.212813,1756381913.2997046,0.08689165115356445
171,rephrase_question,1,0,0,0,1756381927.3685048,1756381927.368625,0.0001201629638671875
172,intent_identification,1,1152,120,1272,1756381927.3688715,1756381929.1853395,1.8164680004119873
173,map_indices_to_names,1,0,0,0,1756381929.186152,1756381929.1950498,0.008897781372070312
174,sql_generation,1,759,18,777,1756381929.19565,1756381930.0047011,0.8090510368347168
175,sql_execution,1,0,0,0,1756381930.0054324,1756381930.0956821,0.09024977684020996
176,rephrase_question,1,0,0,0,1756381956.1361523,1756381956.1364436,0.0002913475036621094
177,intent_identification,1,1153,143,1296,1756381956.1370227,1756381957.9588852,1.8218624591827393
178,map_indices_to_names,1,0,0,0,1756381957.9596293,1756381957.970559,0.010929584503173828
179,sql_generation,1,760,18,778,1756381957.9714391,1756381958.6816583,0.710219144821167
180,sql_execution,1,0,0,0,1756381958.6823657,1756381958.7688718,0.08650612831115723
181,rephrase_question,1,0,0,0,1756382555.9939742,1756382555.9966183,0.002644062042236328
182,intent_identification,1,1350,122,1472,1756382555.9972622,1756382559.145031,3.14776873588562
183,map_indices_to_names,1,0,0,0,1756382559.1457162,1756382559.1547732,0.009057044982910156
184,sql_generation,1,760,18,778,1756382559.155598,1756382559.956942,0.8013441562652588
185,sql_execution,1,0,0,0,1756382559.9576468,1756382560.6530159,0.6953690052032471
186,rephrase_question,1,0,0,0,1756382759.2436705,1756382759.2451258,0.0014553070068359375
187,intent_identification,1,1349,134,1483,1756382759.2455559,1756382762.5079188,3.2623629570007324
188,map_indices_to_names,1,0,0,0,1756382762.5086732,1756382762.5175736,0.00890040397644043
189,sql_generation,1,759,14,773,1756382762.5183206,1756382763.1729906,0.654670000076294
190,sql_execution,1,0,0,0,1756382763.1737888,1756382764.240041,1.0662522315979004
191,rephrase_question,1,0,0,0,1756382893.8947582,1756382893.8952622,0.0005040168762207031
192,intent_identification,1,1349,115,1464,1756382893.8964171,1756382895.6214762,1.7250590324401855
193,map_indices_to_names,1,0,0,0,1756382895.6219976,1756382895.6351814,0.013183832168579102
194,sql_generation,1,759,18,777,1756382895.6361675,1756382896.438015,0.8018474578857422
195,sql_execution,1,0,0,0,1756382896.4387665,1756382896.5770714,0.1383049488067627
196,rephrase_question,1,0,0,0,1756383101.304767,1756383101.3071983,0.0024313926696777344
197,intent_identification,1,2357,128,2485,1756383101.307932,1756383103.4908667,2.1829347610473633
198,map_indices_to_names,1,0,0,0,1756383103.491697,1756383103.5023236,0.010626554489135742
199,sql_generation,1,759,18,777,1756383103.5031044,1756383104.204444,0.7013394832611084
200,sql_execution,1,0,0,0,1756383104.205647,1756383104.6602123,0.45456528663635254
201,rephrase_question,1,0,0,0,1756383271.4385498,1756383271.4390068,0.0004570484161376953
202,intent_identification,1,2359,138,2497,1756383271.4393942,1756383273.2640727,1.8246784210205078
203,map_indices_to_names,1,0,0,0,1756383273.2646453,1756383273.2704606,0.005815267562866211
204,sql_generation,1,759,18,777,1756383273.2709506,1756383273.9316,0.6606495380401611
205,sql_execution,1,0,0,0,1756383273.9322062,1756383274.0269556,0.09474945068359375
206,rephrase_question,1,0,0,0,1756383308.4403622,1756383308.4408221,0.00045990943908691406
207,intent_identification,1,2363,120,2483,1756383308.441358,1756383310.330156,1.8887979984283447
208,map_indices_to_names,1,0,0,0,1756383310.330709,1756383310.340088,0.009378910064697266
209,sql_generation,1,763,13,776,1756383310.3406606,1756383311.023534,0.6828734874725342
210,sql_execution,1,0,0,0,1756383311.0246,1756383311.1229513,0.09835124015808105
211,rephrase_question,1,0,0,0,1756383328.5472908,1756383328.5476062,0.0003154277801513672
212,intent_identification,1,2363,164,2527,1756383328.5479999,1756383330.8107028,2.2627029418945312
213,map_indices_to_names,1,0,0,0,1756383330.8113902,1756383330.8229866,0.011596441268920898
214,sql_generation,1,763,18,781,1756383330.8250973,1756383331.527905,0.7028076648712158
215,sql_execution,1,0,0,0,1756383331.5285475,1756383331.6649354,0.13638782501220703
216,rephrase_question,1,0,0,0,1756383336.5747302,1756383336.575067,0.0003368854522705078
217,intent_identification,1,2363,122,2485,1756383336.5755498,1756383338.3909054,1.8153555393218994
218,map_indices_to_names,1,0,0,0,1756383338.3914921,1756383338.4022152,0.010723114013671875
219,sql_generation,1,763,18,781,1756383338.4027948,1756383339.0882635,0.6854686737060547
220,sql_execution,1,0,0,0,1756383339.0893655,1756383339.166134,0.07676863670349121
221,rephrase_question,1,0,0,0,1756383343.1574743,1756383343.157765,0.0002906322479248047
222,intent_identification,1,2363,142,2505,1756383343.1583035,1756383345.146204,1.9879004955291748
223,map_indices_to_names,1,0,0,0,1756383345.1466424,1756383345.1552036,0.008561134338378906
224,sql_generation,1,763,18,781,1756383345.1557717,1756383345.8629324,0.7071607112884521
225,sql_execution,1,0,0,0,1756383345.8633497,1756383345.9535725,0.09022283554077148
226,rephrase_question,1,0,0,0,1756383377.7207575,1756383377.7209826,0.000225067138671875
227,intent_identification,1,2365,173,2538,1756383377.7214134,1756383379.8580692,2.136655807495117
228,map_indices_to_names,1,0,0,0,1756383379.8588877,1756383379.8682082,0.009320497512817383
229,sql_generation,1,765,14,779,1756383379.8698423,1756383380.6482625,0.7784202098846436
230,sql_execution,1,0,0,0,1756383380.6490839,1756383380.7814822,0.13239836692810059
231,rephrase_question,1,0,0,0,1756383530.5400708,1756383530.5403452,0.00027441978454589844
232,intent_identification,1,2365,175,2540,1756383530.5413568,1756383532.6370862,2.095729351043701
233,map_indices_to_names,1,0,0,0,1756383532.6376345,1756383532.6464624,0.008827924728393555
234,sql_generation,1,765,18,783,1756383532.6477313,1756383533.3550396,0.707308292388916
235,sql_execution,1,0,0,0,1756383533.3554592,1756383533.460306,0.10484671592712402
236,rephrase_question,1,0,0,0,1756385123.9826229,1756385123.982901,0.00027823448181152344
237,intent_identification,1,2365,160,2525,1756385123.983393,1756385127.2865214,3.303128480911255
238,map_indices_to_names,1,0,0,0,1756385127.2883973,1756385127.306182,0.017784595489501953
239,sql_generation,1,765,18,783,1756385127.3073487,1756385128.002487,0.6951382160186768
240,sql_execution,1,0,0,0,1756385128.0033245,1756385128.2356281,0.23230361938476562
241,rephrase_question,1,0,0,0,1756385162.6340578,1756385162.6343699,0.0003120899200439453
242,intent_identification,1,2368,184,2552,1756385162.635122,1756385164.875315,2.2401928901672363
243,map_indices_to_names,1,0,0,0,1756385164.8762572,1756385164.8906891,0.014431953430175781
244,sql_generation,1,768,18,786,1756385164.892124,1756385165.6923082,0.8001842498779297
245,sql_execution,1,0,0,0,1756385165.692782,1756385165.735272,0.04249000549316406
246,rephrase_question,1,0,0,0,1756385171.319415,1756385171.3199415,0.00052642822265625
247,intent_identification,1,2368,153,2521,1756385171.3206596,1756385173.3675706,2.0469110012054443
248,map_indices_to_names,1,0,0,0,1756385173.368514,1756385173.3789194,0.010405302047729492
249,sql_generation,1,768,14,782,1756385173.3824692,1756385174.081908,0.6994388103485107
250,sql_execution,1,0,0,0,1756385174.082752,1756385174.129471,0.04671907424926758
251,rephrase_question,1,0,0,0,1756385208.8372006,1756385208.837404,0.0002033710479736328
252,intent_identification,1,2358,153,2511,1756385208.8384023,1756385211.046339,2.2079367637634277
253,map_indices_to_names,1,0,0,0,1756385211.046998,1756385211.0571702,0.010172128677368164
254,sql_generation,1,758,18,776,1756385211.0584736,1756385212.1804383,1.121964693069458
255,sql_execution,1,0,0,0,1756385212.1819177,1756385212.5074625,0.3255448341369629
256,rephrase_question,1,0,0,0,1756385229.0553374,1756385229.0555878,0.0002503395080566406
257,intent_identification,1,2358,66,2424,1756385229.0558705,1756385230.4040873,1.3482167720794678
258,map_indices_to_names,1,0,0,0,1756385230.4053175,1756385230.4193928,0.014075279235839844
259,sql_generation,1,757,18,775,1756385230.4238818,1756385231.169296,0.7454142570495605
260,sql_execution,1,0,0,0,1756385231.1707785,1756385231.2117577,0.04097914695739746
261,rephrase_question,1,0,0,0,1756385255.961805,1756385255.9620068,0.00020170211791992188
262,intent_identification,1,2359,161,2520,1756385255.962958,1756385257.9447722,1.9818141460418701
263,map_indices_to_names,1,0,0,0,1756385257.9458783,1756385257.960785,0.014906644821166992
264,sql_generation,1,758,18,776,1756385257.9643388,1756385258.6434674,0.6791286468505859
265,sql_execution,1,0,0,0,1756385258.643979,1756385258.7312112,0.08723211288452148
266,rephrase_question,1,0,0,0,1756385705.9946778,1756385705.996793,0.0021152496337890625
267,intent_identification,1,2361,123,2484,1756385705.9974134,1756385708.2994747,2.3020613193511963
268,map_indices_to_names,1,0,0,0,1756385708.3001025,1756385708.3098414,0.009738922119140625
269,sql_generation,1,761,18,779,1756385708.310739,1756385708.9855914,0.6748523712158203
270,sql_execution,1,0,0,0,1756385708.986419,1756385709.4429235,0.45650458335876465
271,rephrase_question,1,0,0,0,1756385840.9939997,1756385840.994333,0.0003333091735839844
272,intent_identification,1,2358,141,2499,1756385840.995214,1756385843.0486486,2.0534346103668213
273,map_indices_to_names,1,0,0,0,1756385843.049311,1756385843.0676198,0.01830887794494629
274,sql_generation,1,758,14,772,1756385843.0690348,1756385843.749312,0.6802771091461182
275,sql_execution,1,0,0,0,1756385843.7504523,1756385843.8380156,0.08756327629089355
276,rephrase_question,1,0,0,0,1756385880.8724241,1756385880.872682,0.0002579689025878906
277,intent_identification,1,2365,152,2517,1756385880.8736684,1756385882.9825737,2.10890531539917
278,map_indices_to_names,1,0,0,0,1756385882.9831173,1756385882.9933386,0.010221242904663086
279,sql_generation,1,764,14,778,1756385882.9943578,1756385883.7085538,0.714195966720581
280,sql_execution,1,0,0,0,1756385883.7092671,1756385883.7888913,0.07962417602539062
281,rephrase_question,1,0,0,0,1756386373.6221275,1756386373.6224785,0.0003509521484375
282,intent_identification,1,2370,247,2617,1756386373.6228845,1756386376.7498267,3.1269421577453613
283,map_indices_to_names,1,0,0,0,1756386376.7509637,1756386376.7627633,0.01179957389831543
284,sql_generation,1,770,18,788,1756386376.763438,1756386377.6715415,0.9081034660339355
285,sql_execution,1,0,0,0,1756386377.672402,1756386377.9732182,0.30081629753112793
286,rephrase_question,1,0,0,0,1756386507.8580081,1756386507.8584132,0.0004050731658935547
287,intent_identification,1,2359,149,2508,1756386507.8590574,1756386509.7203684,1.8613109588623047
288,map_indices_to_names,1,0,0,0,1756386509.7207968,1756386509.730894,0.010097265243530273
289,sql_generation,1,759,14,773,1756386509.7318177,1756386510.332398,0.6005802154541016
290,sql_execution,1,0,0,0,1756386510.332762,1756386510.4055517,0.07278966903686523
291,rephrase_question,1,0,0,0,1756386694.6502993,1756386694.6505468,0.0002474784851074219
292,intent_identification,1,2359,76,2435,1756386694.652079,1756386696.0898917,1.4378125667572021
293,map_indices_to_names,1,0,0,0,1756386696.0908453,1756386696.1111388,0.020293474197387695
294,sql_generation,1,759,18,777,1756386696.116895,1756386696.9065762,0.7896811962127686
295,sql_execution,1,0,0,0,1756386696.9079595,1756386696.983358,0.07539844512939453
296,rephrase_question,1,0,0,0,1756386775.5332575,1756386775.5336566,0.0003991127014160156
297,intent_identification,1,2359,78,2437,1756386775.5342214,1756386777.083833,1.5496115684509277
298,map_indices_to_names,1,0,0,0,1756386777.084516,1756386777.099255,0.014739036560058594
299,sql_generation,1,759,18,777,1756386777.1003938,1756386777.8009715,0.7005777359008789
300,sql_execution,1,0,0,0,1756386777.8026195,1756386777.8795085,0.0768890380859375
301,rephrase_question,1,0,0,0,1756386783.4500115,1756386783.4509156,0.000904083251953125
302,intent_identification,1,2359,78,2437,1756386783.4516227,1756386784.9712393,1.5196166038513184
303,map_indices_to_names,1,0,0,0,1756386784.971742,1756386784.9918013,0.02005934715270996
304,sql_generation,1,759,18,777,1756386784.9957752,1756386785.7739449,0.7781696319580078
305,sql_execution,1,0,0,0,1756386785.7745748,1756386785.8541996,0.07962489128112793
306,rephrase_question,1,0,0,0,1756399244.2132416,1756399244.2139814,0.0007398128509521484
307,intent_identification,1,2371,82,2453,1756399244.2142446,1756399246.4458704,2.23162579536438
308,map_indices_to_names,1,0,0,0,1756399246.4462564,1756399246.4510953,0.0048389434814453125
309,sql_generation,1,759,18,777,1756399246.4516585,1756399247.3180141,0.8663556575775146
310,sql_execution,1,0,0,0,1756399247.3186674,1756399247.6192749,0.30060744285583496
311,rephrase_question,1,0,0,0,1756399989.894503,1756399989.8954923,0.0009891986846923828
312,intent_identification,1,1972,78,2050,1756399989.8957894,1756399993.016485,3.1206955909729004
313,map_indices_to_names,1,0,0,0,1756399993.016622,1756399993.02009,0.003468036651611328
314,sql_generation,1,759,18,777,1756399993.0205045,1756399993.7254546,0.7049500942230225
315,sql_execution,1,0,0,0,1756399993.7255847,1756399994.00672,0.28113532066345215
316,rephrase_question,1,0,0,0,1756400283.2647626,1756400283.2656467,0.0008840560913085938
317,intent_identification,1,482,94,576,1756400283.265994,1756400285.9715652,2.705571174621582
318,map_indices_to_names,1,0,0,0,1756400285.971842,1756400285.9771466,0.005304574966430664
319,sql_generation,1,759,18,777,1756400285.9776058,1756400286.6992843,0.7216784954071045
320,sql_execution,1,0,0,0,1756400286.700708,1756400287.0788946,0.3781867027282715
321,rephrase_question,1,0,0,0,1756400336.9079573,1756400336.9082074,0.00025010108947753906
322,intent_identification,1,482,99,581,1756400336.9084373,1756400338.6582217,1.7497844696044922
323,map_indices_to_names,1,0,0,0,1756400338.6591523,1756400338.66656,0.007407665252685547
324,sql_generation,1,764,18,782,1756400338.671939,1756400339.558374,0.8864350318908691
325,sql_execution,1,0,0,0,1756400339.5628257,1756400339.6164272,0.05360150337219238
326,rephrase_question,1,0,0,0,1756400401.2656713,1756400401.2664201,0.0007488727569580078
327,intent_identification,1,1978,132,2110,1756400401.2665703,1756400403.3404012,2.0738308429718018
328,map_indices_to_names,1,0,0,0,1756400403.3407707,1756400403.3455684,0.004797697067260742
329,sql_generation,1,764,14,778,1756400403.3459322,1756400404.021184,0.6752517223358154
330,sql_execution,1,0,0,0,1756400404.0218177,1756400404.271736,0.24991822242736816
331,rephrase_question,1,0,0,0,1756400854.2928822,1756400854.2941604,0.0012781620025634766
332,intent_identification,1,1978,145,2123,1756400854.2944686,1756400858.4414487,4.146980047225952
333,sql_generation,1,764,17,781,1756400858.4418063,1756400859.1140025,0.6721961498260498
334,sql_execution,1,0,0,0,1756400859.1140954,1756400859.464178,0.3500826358795166
335,rephrase_question,1,0,0,0,1756401028.3713388,1756401028.3720522,0.000713348388671875
336,intent_identification,1,1962,65,2027,1756401028.3723202,1756401030.0185814,1.646261215209961
337,sql_generation,1,764,14,778,1756401030.0189033,1756401030.7345743,0.7156710624694824
338,sql_execution,1,0,0,0,1756401030.7353423,1756401030.9364738,0.20113158226013184
339,rephrase_question,1,0,0,0,1756401881.244497,1756401881.246556,0.0020589828491210938
340,intent_identification,1,1971,65,2036,1756401881.2470737,1756401883.0295784,1.7825047969818115
341,sql_generation,1,764,14,778,1756401883.0304148,1756401883.6728768,0.6424620151519775
342,sql_execution,1,0,0,0,1756401883.673809,1756401883.9969342,0.32312512397766113
343,rephrase_question,1,0,0,0,1756402406.8448992,1756402406.847199,0.002299785614013672
344,intent_identification,1,1976,73,2049,1756402406.847769,1756402409.5982928,2.750523805618286
345,sql_generation,1,764,18,782,1756402409.5989168,1756402410.2419958,0.6430790424346924
346,sql_execution,1,0,0,0,1756402410.2426817,1756402410.4683282,0.2256464958190918
347,rephrase_question,1,0,0,0,1756402577.4713323,1756402577.4715588,0.00022649765014648438
348,intent_identification,1,1969,45,2014,1756402577.4726882,1756402579.488286,2.0155978202819824
349,sql_generation,1,757,18,775,1756402579.4895926,1756402580.253281,0.7636885643005371
350,sql_execution,1,0,0,0,1756402580.2542598,1756402580.289328,0.03506827354431152
351,rephrase_question,1,0,0,0,1756402607.1787663,1756402607.1794002,0.0006339550018310547
352,intent_identification,1,1970,46,2016,1756402607.1822622,1756402608.5197747,1.337512493133545
353,sql_generation,1,758,14,772,1756402608.5209367,1756402609.2332203,0.7122836112976074
354,sql_execution,1,0,0,0,1756402609.234041,1756402609.2728887,0.03884768486022949
355,rephrase_question,1,0,0,0,1756402636.0348444,1756402636.0351317,0.0002872943878173828
356,intent_identification,1,1980,53,2033,1756402636.0361583,1756402637.2900598,1.253901481628418
357,sql_generation,1,768,15,783,1756402637.2906945,1756402639.3022199,2.0115253925323486
358,sql_execution,1,0,0,0,1756402639.303772,1756402639.3466706,0.04289865493774414
359,rephrase_question,1,0,0,0,1756402709.901894,1756402709.9021568,0.0002627372741699219
360,intent_identification,1,1981,68,2049,1756402709.902488,1756402711.2276683,1.3251802921295166
361,sql_generation,1,769,18,787,1756402711.228184,1756402711.9377954,0.7096114158630371
362,sql_execution,1,0,0,0,1756402711.9385765,1756402711.971414,0.032837629318237305
363,rephrase_question,1,0,0,0,1756402774.848898,1756402774.8492594,0.00036144256591796875
364,intent_identification,1,1977,45,2022,1756402774.8497055,1756402776.0395267,1.1898212432861328
365,sql_generation,1,765,18,783,1756402776.0400221,1756402776.7578256,0.7178034782409668
366,sql_execution,1,0,0,0,1756402776.7585857,1756402776.7946644,0.036078691482543945
367,rephrase_question,1,0,0,0,1756402811.8850944,1756402811.8854651,0.0003707408905029297
368,intent_identification,1,1980,62,2042,1756402811.8859055,1756402813.162317,1.276411533355713
369,sql_generation,1,768,18,786,1756402813.16296,1756402813.8831854,0.7202253341674805
370,sql_execution,1,0,0,0,1756402813.8854902,1756402813.9270818,0.041591644287109375
371,rephrase_question,1,0,0,0,1756402842.4099622,1756402842.410187,0.00022482872009277344
372,intent_identification,1,1969,51,2020,1756402842.4106894,1756402843.8053026,1.394613265991211
373,sql_generation,1,757,18,775,1756402843.8064134,1756402844.4453566,0.6389431953430176
374,sql_execution,1,0,0,0,1756402844.4461694,1756402844.4809332,0.03476381301879883
375,rephrase_question,1,0,0,0,1756402863.665581,1756402863.6658134,0.00023245811462402344
376,intent_identification,1,1973,61,2034,1756402863.667325,1756402864.9550421,1.2877171039581299
377,sql_generation,1,761,18,779,1756402864.9555051,1756402867.172006,2.216500759124756
378,sql_execution,1,0,0,0,1756402867.1724157,1756402867.232358,0.05994224548339844
379,rephrase_question,1,0,0,0,1756450362.0599518,1756450362.0624015,0.0024497509002685547
380,intent_identification,1,1981,57,2038,1756450362.0630438,1756450363.7868516,1.7238078117370605
381,sql_generation,1,768,15,783,1756450363.787367,1756450364.4107828,0.6234157085418701
382,sql_execution,1,0,0,0,1756450364.4111717,1756450364.9897466,0.5785748958587646
383,rephrase_question,1,0,0,0,1756450631.173593,1756450631.1757138,0.0021207332611083984
384,intent_identification,1,1985,65,2050,1756450631.1762457,1756450634.1199632,2.9437174797058105
385,sql_generation,1,768,14,782,1756450634.1203053,1756450634.746736,0.6264307498931885
386,sql_execution,1,0,0,0,1756450634.7473795,1756450635.2663195,0.5189399719238281
387,rephrase_question,1,0,0,0,1756450813.000847,1756450813.0030627,0.0022156238555908203
388,intent_identification,1,1982,68,2050,1756450813.0036724,1756450814.9157057,1.9120333194732666
389,sql_generation,1,768,14,782,1756450814.9163084,1756450815.8734543,0.9571459293365479
390,sql_execution,1,0,0,0,1756450815.8744607,1756450816.2987885,0.4243278503417969
391,rephrase_question,1,0,0,0,1756450899.3259568,1756450899.326311,0.0003542900085449219
392,intent_identification,1,1982,61,2043,1756450899.3265352,1756450900.6586316,1.3320963382720947
393,sql_generation,1,768,18,786,1756450900.6591115,1756450901.2793398,0.6202282905578613
394,sql_execution,1,0,0,0,1756450901.2802458,1756450901.3595266,0.07928085327148438
395,rephrase_question,1,0,0,0,1756450964.9078925,1756450964.9082265,0.00033402442932128906
396,intent_identification,1,1996,68,2064,1756450964.9087396,1756450966.2967398,1.388000249862671
397,sql_generation,1,768,14,782,1756450966.2971125,1756450966.9272072,0.6300947666168213
398,sql_execution,1,0,0,0,1756450966.9280512,1756450967.0072186,0.07916736602783203
399,rephrase_question,1,0,0,0,1756451018.6702964,1756451018.6705198,0.00022339820861816406
400,intent_identification,1,1993,68,2061,1756451018.670678,1756451019.9889233,1.3182454109191895
401,sql_generation,1,768,17,785,1756451019.9894795,1756451020.6804187,0.69093918800354
402,sql_execution,1,0,0,0,1756451020.6811411,1756451020.7636125,0.08247137069702148
403,rephrase_question,1,0,0,0,1756451332.360712,1756451332.3639166,0.0032045841217041016
404,intent_identification,1,2017,70,2087,1756451332.3645988,1756451334.2157085,1.8511097431182861
405,sql_generation,1,768,18,786,1756451334.216287,1756451334.9342382,0.7179512977600098
406,sql_execution,1,0,0,0,1756451334.934803,1756451335.4588857,0.5240826606750488
407,rephrase_question,1,0,0,0,1756451361.5219467,1756451361.5221736,0.0002269744873046875
408,intent_identification,1,2006,51,2057,1756451361.5230005,1756451362.6795049,1.1565043926239014
409,sql_generation,1,757,14,771,1756451362.6801438,1756451363.3968146,0.7166707515716553
410,sql_execution,1,0,0,0,1756451363.398083,1756451363.4904356,0.09235262870788574
411,rephrase_question,1,0,0,0,1756451382.100856,1756451382.101087,0.00023102760314941406
412,intent_identification,1,2010,60,2070,1756451382.1019363,1756451383.2617164,1.1597800254821777
413,sql_generation,1,761,17,778,1756451383.2624025,1756451383.9806242,0.7182216644287109
414,sql_execution,1,0,0,0,1756451383.9814014,1756451384.0606017,0.07920026779174805
415,rephrase_question,1,0,0,0,1756451409.0226123,1756451409.022958,0.0003457069396972656
416,intent_identification,1,2014,48,2062,1756451409.0234368,1756451410.1931505,1.1697137355804443
417,sql_generation,1,765,18,783,1756451410.1937234,1756451410.9249682,0.7312448024749756
418,sql_execution,1,0,0,0,1756451410.925913,1756451411.0157785,0.08986544609069824
419,rephrase_question,1,0,0,0,1756451434.6470463,1756451434.6473072,0.0002608299255371094
420,intent_identification,1,2018,63,2081,1756451434.648257,1756451435.8568814,1.2086243629455566
421,sql_generation,1,769,18,787,1756451435.8573797,1756451436.6124845,0.7551047801971436
422,sql_execution,1,0,0,0,1756451436.613751,1756451436.6951392,0.08138823509216309
423,rephrase_question,1,0,0,0,1756451464.4262266,1756451464.4271374,0.0009107589721679688
424,intent_identification,1,2007,46,2053,1756451464.4319777,1756451465.5404286,1.1084508895874023
425,sql_generation,1,758,14,772,1756451465.5408025,1756451466.3061743,0.7653717994689941
426,sql_execution,1,0,0,0,1756451466.3066747,1756451466.3888118,0.0821371078491211
427,rephrase_question,1,0,0,0,1756451486.6213317,1756451486.6215868,0.0002551078796386719
428,intent_identification,1,2013,77,2090,1756451486.6224356,1756451487.9330475,1.3106119632720947
429,sql_generation,1,764,14,778,1756451487.9337518,1756451488.526654,0.5929021835327148
430,sql_execution,1,0,0,0,1756451488.5281775,1756451488.605818,0.07764053344726562
431,rephrase_question,1,0,0,0,1756451606.3243053,1756451606.327225,0.0029196739196777344
432,intent_identification,1,2013,77,2090,1756451606.327824,1756451608.131805,1.803980827331543
433,rephrase_question,1,0,0,0,1756451722.9856663,1756451722.988967,0.0033006668090820312
434,intent_identification,1,2013,77,2090,1756451722.9896576,1756451725.824845,2.8351874351501465
435,rephrase_question,1,0,0,0,1756451833.0181732,1756451833.0206048,0.002431631088256836
436,intent_identification,1,2013,77,2090,1756451833.0211859,1756451834.6313012,1.6101152896881104
437,rephrase_question,1,0,0,0,1756452673.7445455,1756452673.7478352,0.0032896995544433594
438,intent_identification,1,2001,59,2060,1756452673.7484841,1756452676.6083422,2.8598580360412598
439,rephrase_question,1,0,0,0,1756452692.9675498,1756452692.9677706,0.00022077560424804688
440,intent_identification,1,2011,77,2088,1756452692.9679806,1756452694.2409017,1.272921085357666
441,rephrase_question,1,0,0,0,1756452746.940524,1756452746.94077,0.00024580955505371094
442,intent_identification,1,2001,56,2057,1756452746.9411876,1756452748.0018866,1.0606989860534668
443,rephrase_question,1,0,0,0,1756453558.550858,1756453558.553308,0.0024499893188476562
444,intent_identification,1,2027,60,2087,1756453558.5539992,1756453560.3320072,1.778007984161377
445,rephrase_question,1,0,0,0,1756453596.3017838,1756453596.3021243,0.00034046173095703125
446,intent_identification,1,2037,77,2114,1756453596.3025496,1756453597.6009116,1.2983620166778564
447,rephrase_question,1,0,0,0,1756453838.3953993,1756453838.3977063,0.0023069381713867188
448,intent_identification,1,2058,72,2130,1756453838.3983188,1756453839.8439114,1.4455926418304443
449,rephrase_question,1,0,0,0,1756453945.4152417,1756453945.4157324,0.0004906654357910156
450,intent_identification,1,2058,72,2130,1756453945.4175246,1756453946.7251954,1.3076708316802979
451,rephrase_question,1,0,0,0,1756454037.9809833,1756454037.9836771,0.0026938915252685547
452,intent_identification,1,2061,77,2138,1756454037.9841619,1756454040.987796,3.003634214401245
453,rephrase_question,1,0,0,0,1756454246.698717,1756454246.702036,0.00331878662109375
454,intent_identification,1,2128,101,2229,1756454246.7027092,1756454248.7562463,2.053537130355835
455,rephrase_question,1,0,0,0,1756454263.162136,1756454263.1627517,0.0006155967712402344
456,intent_identification,1,2122,56,2178,1756454263.163272,1756454264.4221148,1.258842945098877
457,rephrase_question,1,0,0,0,1756454292.4441783,1756454292.4444945,0.0003161430358886719
458,intent_identification,1,2122,44,2166,1756454292.4450734,1756454293.5030751,1.0580017566680908
459,rephrase_question,1,0,0,0,1756454310.2939384,1756454310.2942426,0.00030422210693359375
460,intent_identification,1,2132,82,2214,1756454310.2947474,1756454311.6259522,1.331204891204834
461,rephrase_question,1,0,0,0,1756454346.1981359,1756454346.1983879,0.00025200843811035156
462,intent_identification,1,2129,63,2192,1756454346.1993413,1756454347.3908024,1.1914610862731934
463,rephrase_question,1,0,0,0,1756454363.0809994,1756454363.0812876,0.00028824806213378906
464,intent_identification,1,2132,97,2229,1756454363.0822327,1756454364.5665538,1.484321117401123
465,rephrase_question,1,0,0,0,1756454385.4492178,1756454385.4496477,0.0004298686981201172
466,intent_identification,1,2131,90,2221,1756454385.4506361,1756454386.8904016,1.439765453338623
467,rephrase_question,1,0,0,0,1756454579.954462,1756454579.9549713,0.0005092620849609375
468,intent_identification,1,2131,105,2236,1756454579.955571,1756454581.7568932,1.8013222217559814
469,rephrase_question,1,0,0,0,1756454632.1048424,1756454632.1054218,0.0005793571472167969
470,intent_identification,1,2125,67,2192,1756454632.1154313,1756454633.4674287,1.3519973754882812
471,rephrase_question,1,0,0,0,1756454648.126958,1756454648.1272595,0.00030159950256347656
472,intent_identification,1,2129,81,2210,1756454648.1282644,1756454649.6455152,1.5172507762908936
473,rephrase_question,1,0,0,0,1756454703.5007946,1756454703.5010982,0.00030350685119628906
474,intent_identification,1,2132,97,2229,1756454703.5020716,1756454705.1446147,1.642543077468872
475,rephrase_question,1,0,0,0,1756471660.2059345,1756471660.2085934,0.002658843994140625
476,intent_identification,1,1127,32,1159,1756471660.2090814,1756471662.9200072,2.710925817489624
477,rephrase_question,1,0,0,0,1756471858.824849,1756471858.827088,0.002239227294921875
478,intent_identification,1,1148,32,1180,1756471858.827574,1756471860.1400259,1.3124518394470215
479,rephrase_question,1,0,0,0,1756471865.9530907,1756471865.9534152,0.00032448768615722656
480,intent_identification,1,1148,40,1188,1756471865.9538598,1756471867.0010793,1.0472195148468018
481,rephrase_question,1,0,0,0,1756471967.6339085,1756471967.6359816,0.002073049545288086
482,intent_identification,1,1142,41,1183,1756471967.6365185,1756471969.1430306,1.50651216506958
483,rephrase_question,1,0,0,0,1756472048.9169993,1756472048.9191759,0.002176523208618164
484,intent_identification,1,1139,40,1179,1756472048.9196928,1756472051.4212723,2.501579523086548
485,rephrase_question,1,0,0,0,1756472261.0089014,1756472261.0115674,0.002665996551513672
486,intent_identification,1,1145,44,1189,1756472261.0121415,1756472263.6155655,2.603424072265625
487,rephrase_question,1,0,0,0,1756472345.937146,1756472345.9394126,0.0022666454315185547
488,intent_identification,1,1143,38,1181,1756472345.9399533,1756472347.2508485,1.3108952045440674
489,rephrase_question,1,0,0,0,1756473797.2732954,1756473797.2754636,0.0021681785583496094
490,intent_identification,1,738,69,807,1756473797.2761025,1756473798.8398924,1.5637898445129395
491,rephrase_question,1,0,0,0,1756474019.3288476,1756474019.3291025,0.0002548694610595703
492,intent_identification,1,735,69,804,1756474019.3296895,1756474020.6479754,1.3182859420776367
493,rephrase_question,1,0,0,0,1756476900.98911,1756476900.9912841,0.0021741390228271484
494,intent_identification,1,735,74,809,1756476900.9918866,1756476902.5353005,1.5434138774871826
495,column_identification,1,1714,80,1794,1756476902.5359848,1756476904.0904584,1.554473638534546
496,rephrase_question,1,0,0,0,1756476969.0331573,1756476969.0338154,0.0006580352783203125
497,intent_identification,1,731,42,773,1756476969.0349376,1756476970.1356456,1.1007080078125
498,column_identification,1,1678,55,1733,1756476970.1365442,1756476971.569626,1.433081865310669
499,rephrase_question,1,0,0,0,1756477192.04303,1756477192.0456533,0.002623319625854492
500,intent_identification,1,731,51,782,1756477192.0462108,1756477193.6735063,1.6272954940795898
501,column_identification,1,1717,57,1774,1756477193.673867,1756477195.0030918,1.3292248249053955
502,rephrase_question,1,0,0,0,1756477263.600505,1756477263.600767,0.0002617835998535156
503,intent_identification,1,741,57,798,1756477263.6064727,1756477264.839292,1.2328193187713623
504,column_identification,1,1732,84,1816,1756477264.8400905,1756477266.480065,1.639974594116211
505,rephrase_question,1,0,0,0,1756477395.6975822,1756477395.6995566,0.001974344253540039
506,intent_identification,1,741,47,788,1756477395.6999493,1756477396.9401252,1.2401759624481201
507,column_identification,1,1732,80,1812,1756477396.9409492,1756477398.4711444,1.5301952362060547
508,rephrase_question,1,0,0,0,1756477403.8585815,1756477403.8588455,0.0002639293670654297
509,intent_identification,1,741,47,788,1756477403.8594415,1756477404.922998,1.063556432723999
510,column_identification,1,1732,80,1812,1756477404.923775,1756477406.4183416,1.4945666790008545
511,rephrase_question,1,0,0,0,1756477731.7747061,1756477731.7774305,0.0027244091033935547
512,intent_identification,1,741,47,788,1756477731.7780237,1756477734.441921,2.6638972759246826
513,column_identification,1,1749,71,1820,1756477734.4430099,1756477736.0789475,1.6359376907348633
514,rephrase_question,1,0,0,0,1756638470.2823205,1756638470.2891517,0.006831169128417969
515,intent_identification,1,741,47,788,1756638470.2933013,1756638472.9756217,2.6823203563690186
516,column_identification,1,1749,70,1819,1756638472.9764235,1756638474.3423622,1.365938663482666
517,rephrase_question,1,0,0,0,1756638513.5473232,1756638513.5476863,0.0003631114959716797
518,intent_identification,1,742,70,812,1756638513.5481408,1756638514.8534126,1.305271863937378
519,column_identification,1,1772,109,1881,1756638514.854364,1756638516.5976717,1.7433078289031982
520,rephrase_question,1,0,0,0,1756639169.8839438,1756639169.8842716,0.00032782554626464844
521,intent_identification,1,742,70,812,1756639169.884882,1756639171.1783292,1.2934472560882568
522,column_identification,1,1772,109,1881,1756639171.1787364,1756639172.9675207,1.7887842655181885
523,rephrase_question,1,0,0,0,1756639182.4745018,1756639182.4746695,0.00016760826110839844
524,intent_identification,1,742,81,823,1756639182.47483,1756639183.920164,1.4453341960906982
525,column_identification,1,1772,114,1886,1756639183.9204473,1756639185.7632725,1.842825174331665
526,rephrase_question,1,0,0,0,1756639442.2507124,1756639442.2549963,0.004283905029296875
527,intent_identification,1,742,70,812,1756639442.2556202,1756639445.0356708,2.78005051612854
528,column_identification,1,1279,118,1397,1756639445.0363374,1756639446.8866894,1.8503520488739014
529,rephrase_question,1,0,0,0,1756639591.2575314,1756639591.260427,0.0028955936431884766
530,intent_identification,1,742,70,812,1756639591.2610614,1756639594.2279146,2.966853141784668
531,column_identification,1,1184,113,1297,1756639594.2286355,1756639596.0687065,1.8400709629058838
532,rephrase_question,1,0,0,0,1756639802.8603377,1756639802.8635054,0.0031676292419433594
533,intent_identification,1,742,70,812,1756639802.864089,1756639805.8843708,3.0202817916870117
534,column_identification,1,1172,114,1286,1756639805.88531,1756639807.726394,1.8410840034484863
535,rephrase_question,1,0,0,0,1756639856.1070378,1756639856.107295,0.00025725364685058594
536,intent_identification,1,742,70,812,1756639856.10802,1756639857.4892895,1.3812694549560547
537,column_identification,1,1173,103,1276,1756639857.4900763,1756639859.3099315,1.8198552131652832
538,rephrase_question,1,0,0,0,1756639869.765117,1756639869.7655463,0.00042939186096191406
539,intent_identification,1,742,70,812,1756639869.7658968,1756639871.068323,1.3024260997772217
540,column_identification,1,1173,114,1287,1756639871.0692723,1756639872.8879313,1.8186590671539307
541,rephrase_question,1,0,0,0,1756639901.37497,1756639901.3791037,0.004133701324462891
542,intent_identification,1,742,70,812,1756639901.379669,1756639903.2485716,1.8689026832580566
543,column_identification,1,1173,103,1276,1756639903.249261,1756639904.8714468,1.6221859455108643
544,rephrase_question,1,0,0,0,1756640263.9299998,1756640263.93246,0.0024602413177490234
545,intent_identification,1,742,80,822,1756640263.9332044,1756640266.827537,2.8943326473236084
546,column_identification,1,1184,113,1297,1756640266.8281193,1756640268.7199166,1.8917973041534424
547,rephrase_question,1,0,0,0,1756640312.737502,1756640312.7377803,0.00027823448181152344
548,intent_identification,1,735,66,801,1756640312.738224,1756640314.0819185,1.3436944484710693
549,column_identification,1,1174,109,1283,1756640314.082788,1756640315.8234243,1.7406363487243652
550,rephrase_question,1,0,0,0,1756640435.4118943,1756640435.4146066,0.002712249755859375
551,intent_identification,1,735,66,801,1756640435.415136,1756640438.0962095,2.6810734272003174
552,column_identification,1,1174,103,1277,1756640438.0966005,1756640439.82657,1.7299695014953613
553,rephrase_question,1,0,0,0,1756640554.9600365,1756640554.9605348,0.0004982948303222656
554,intent_identification,1,735,66,801,1756640554.9611175,1756640556.2522368,1.2911193370819092
555,column_identification,1,1174,103,1277,1756640556.2538903,1756640558.0955234,1.8416330814361572
556,rephrase_question,1,0,0,0,1756640573.0931895,1756640573.0936525,0.0004630088806152344
557,intent_identification,1,739,66,805,1756640573.0942402,1756640574.5039418,1.4097015857696533
558,column_identification,1,1178,104,1282,1756640574.505027,1756640576.2260246,1.7209975719451904
559,rephrase_question,1,0,0,0,1756640685.439561,1756640685.4416993,0.002138376235961914
560,intent_identification,1,739,66,805,1756640685.442233,1756640688.2460816,2.8038485050201416
561,column_identification,1,1185,110,1295,1756640688.2468667,1756640689.9827218,1.7358551025390625
562,rephrase_question,1,0,0,0,1756640761.3504977,1756640761.3527575,0.0022597312927246094
563,intent_identification,1,739,66,805,1756640761.3531928,1756640764.0382676,2.685074806213379
564,column_identification,1,1185,109,1294,1756640764.0388093,1756640765.757663,1.7188537120819092
565,rephrase_question,1,0,0,0,1756640827.922973,1756640827.9232757,0.0003027915954589844
566,intent_identification,1,740,66,806,1756640827.9236386,1756640829.2456172,1.3219785690307617
567,column_identification,1,1186,110,1296,1756640829.246546,1756640831.0907376,1.844191551208496
568,rephrase_question,1,0,0,0,1756641110.166683,1756641110.1695135,0.00283050537109375
569,intent_identification,1,740,66,806,1756641110.170076,1756641113.0906026,2.9205267429351807
570,column_identification,1,1177,110,1287,1756641113.0912087,1756641114.9361324,1.844923734664917
571,rephrase_question,1,0,0,0,1756641267.6724043,1756641267.6747396,0.0023353099822998047
572,intent_identification,1,740,69,809,1756641267.6751547,1756641270.6809459,3.005791187286377
573,column_identification,1,1195,109,1304,1756641270.6815848,1756641272.5244164,1.8428316116333008
574,rephrase_question,1,0,0,0,1756642246.0704694,1756642246.0736196,0.0031502246856689453
575,intent_identification,1,740,66,806,1756642246.0743368,1756642248.9879687,2.9136319160461426
576,column_identification,1,1703,115,1818,1756642248.989003,1756642250.9343915,1.9453885555267334
577,rephrase_question,1,0,0,0,1756642312.1165824,1756642312.1167674,0.0001850128173828125
578,intent_identification,1,745,80,825,1756642312.1169622,1756642314.638268,2.521305799484253
579,column_identification,1,1711,123,1834,1756642314.6386912,1756642316.6725771,2.033885955810547
580,rephrase_question,1,0,0,0,1756642321.7383475,1756642321.7385464,0.00019884109497070312
581,intent_identification,1,745,80,825,1756642321.7388754,1756642323.1434073,1.4045319557189941
582,column_identification,1,1711,123,1834,1756642323.1441152,1756642325.1736884,2.0295732021331787
583,rephrase_question,1,0,0,0,1756642378.0458796,1756642378.045999,0.00011944770812988281
584,intent_identification,1,742,70,812,1756642378.0462706,1756642379.3397226,1.2934520244598389
585,column_identification,1,1709,124,1833,1756642379.3402755,1756642381.2409918,1.9007163047790527
586,rephrase_question,1,0,0,0,1756642556.7945023,1756642556.796653,0.0021507740020751953
587,intent_identification,1,742,80,822,1756642556.7970386,1756642559.7645323,2.967493772506714
588,column_identification,1,1619,120,1739,1756642559.7653847,1756642561.813867,2.0484824180603027
589,rephrase_question,1,0,0,0,1756642692.4664624,1756642692.466721,0.0002586841583251953
590,intent_identification,1,742,47,789,1756642692.46769,1756642693.559131,1.0914409160614014
591,column_identification,1,1597,73,1670,1756642693.5598042,1756642695.0312555,1.4714512825012207
592,rephrase_question,1,0,0,0,1756642875.9109015,1756642875.911214,0.00031256675720214844
593,intent_identification,1,738,80,818,1756642875.9120517,1756642877.4048886,1.4928369522094727
594,column_identification,1,1616,115,1731,1756642877.4057267,1756642879.1291099,1.7233831882476807
595,rephrase_question,1,0,0,0,1756648356.3473752,1756648356.3512633,0.0038881301879882812
596,intent_identification,1,738,69,807,1756648356.3519506,1756648359.1883755,2.8364248275756836
597,column_identification,1,1618,115,1733,1756648359.1888843,1756648361.1341732,1.945288896560669
598,rephrase_question,1,0,0,0,1756648404.5033853,1756648404.5036838,0.00029850006103515625
599,intent_identification,1,739,47,786,1756648404.5046673,1756648405.5743349,1.0696675777435303
600,column_identification,1,1596,77,1673,1756648405.5749898,1756648407.0096278,1.4346380233764648
601,rephrase_question,1,0,0,0,1756648446.6146402,1756648446.6148674,0.00022721290588378906
602,intent_identification,1,737,106,843,1756648446.6151202,1756648448.326084,1.7109637260437012
603,column_identification,1,1641,161,1802,1756648448.3271794,1756648450.84774,2.5205605030059814
604,rephrase_question,1,0,0,0,1756648996.350176,1756648996.3522022,0.002026081085205078
605,intent_identification,1,737,93,830,1756648996.3527675,1756648999.359959,3.0071914196014404
606,column_identification,1,1637,161,1798,1756648999.3608036,1756649001.6865344,2.325730800628662
607,rephrase_question,1,0,0,0,1756649014.7660575,1756649014.7663538,0.0002963542938232422
608,intent_identification,1,739,73,812,1756649014.7668552,1756649016.2782297,1.5113744735717773
609,column_identification,1,1619,116,1735,1756649016.2790382,1756649018.2192733,1.9402351379394531
610,rephrase_question,1,0,0,0,1756649217.6537848,1756649217.6567216,0.002936840057373047
611,intent_identification,1,739,80,819,1756649217.6574395,1756649220.8657362,3.208296775817871
612,column_identification,1,1530,75,1605,1756649220.8665266,1756649222.4008014,1.5342748165130615
613,rephrase_question,1,0,0,0,1756649339.5007186,1756649339.5032043,0.0024857521057128906
614,intent_identification,1,739,80,819,1756649339.5036345,1756649341.4893389,1.9857044219970703
615,column_identification,1,1615,115,1730,1756649341.4896815,1756649343.7449515,2.255270004272461
616,rephrase_question,1,0,0,0,1756649500.1792252,1756649500.181232,0.0020067691802978516
617,intent_identification,1,739,69,808,1756649500.1818285,1756649503.0730052,2.891176700592041
618,column_identification,1,1657,120,1777,1756649503.0737445,1756649505.0177407,1.9439961910247803
619,rephrase_question,1,0,0,0,1756649607.296745,1756649607.2976122,0.0008671283721923828
620,intent_identification,1,739,75,814,1756649607.2978275,1756649609.9580507,2.6602232456207275
621,column_identification,1,950,124,1074,1756649609.9584064,1756649611.7582269,1.7998204231262207
622,rephrase_question,1,0,0,0,1756649666.747822,1756649666.748571,0.0007488727569580078
623,intent_identification,1,739,80,819,1756649666.7487597,1756649669.540907,2.792147159576416
624,column_identification,1,944,120,1064,1756649669.5415127,1756649671.3093207,1.767807960510254
625,rephrase_question,1,0,0,0,1756649777.387869,1756649777.3879578,8.893013000488281e-05
626,intent_identification,1,742,93,835,1756649777.3880792,1756649779.133461,1.7453818321228027
627,column_identification,1,971,170,1141,1756649779.133824,1756649781.4872305,2.3534064292907715
628,rephrase_question,1,0,0,0,1756649879.0408404,1756649879.0410593,0.00021886825561523438
629,intent_identification,1,731,47,778,1756649879.0415924,1756649880.0692747,1.0276823043823242
630,column_identification,1,913,88,1001,1756649880.0697548,1756649881.5364642,1.4667093753814697
631,rephrase_question,1,0,0,0,1756649935.2495697,1756649935.249681,0.00011134147644042969
632,intent_identification,1,731,44,775,1756649935.2498038,1756649936.2233093,0.9735054969787598
633,column_identification,1,899,84,983,1756649936.2244382,1756649937.7609558,1.53651762008667
634,rephrase_question,1,0,0,0,1756649990.6586642,1756649990.658753,8.869171142578125e-05
635,intent_identification,1,731,53,784,1756649990.658937,1756649991.8748198,1.2158827781677246
636,column_identification,1,901,79,980,1756649991.8757737,1756649993.2246385,1.3488647937774658
637,rephrase_question,1,0,0,0,1756650004.0676749,1756650004.0678222,0.00014734268188476562
638,intent_identification,1,742,93,835,1756650004.0680094,1756650005.7339263,1.665916919708252
639,column_identification,1,962,171,1133,1756650005.734332,1756650008.1620283,2.4276962280273438
640,rephrase_question,1,0,0,0,1756650071.3139849,1756650071.3143966,0.00041174888610839844
641,intent_identification,1,732,51,783,1756650071.3147666,1756650072.3696275,1.0548608303070068
642,column_identification,1,900,69,969,1756650072.370103,1756650073.7310967,1.3609938621520996
643,rephrase_question,1,0,0,0,1756650106.4753175,1756650106.4755704,0.0002529621124267578
644,intent_identification,1,742,47,789,1756650106.4758031,1756650107.5070238,1.0312206745147705
645,column_identification,1,915,92,1007,1756650107.5076869,1756650109.111883,1.6041960716247559
646,rephrase_question,1,0,0,0,1756650150.2722108,1756650150.2724864,0.00027561187744140625
647,intent_identification,1,739,69,808,1756650150.272752,1756650151.4967022,1.2239501476287842
648,column_identification,1,934,83,1017,1756650151.4969838,1756650152.8019063,1.3049225807189941
649,rephrase_question,1,0,0,0,1756650170.7501533,1756650170.7502892,0.00013589859008789062
650,intent_identification,1,731,47,778,1756650170.7505774,1756650171.879112,1.1285345554351807
651,column_identification,1,904,92,996,1756650171.8795004,1756650173.3675387,1.4880383014678955
652,rephrase_question,1,0,0,0,1756650193.9183514,1756650193.9185424,0.00019097328186035156
653,intent_identification,1,735,66,801,1756650193.918683,1756650195.1036832,1.1850001811981201
654,column_identification,1,927,111,1038,1756650195.1057792,1756650196.8644655,1.7586863040924072
655,rephrase_question,1,0,0,0,1756650226.3339121,1756650226.3340452,0.00013303756713867188
656,intent_identification,1,732,76,808,1756650226.3342083,1756650227.6917613,1.3575530052185059
657,column_identification,1,924,115,1039,1756650227.6932752,1756650229.3836246,1.6903493404388428
658,rephrase_question,1,0,0,0,1756650364.9428988,1756650364.9436083,0.00070953369140625
659,intent_identification,1,743,57,800,1756650364.943906,1756650367.4607272,2.5168211460113525
660,column_identification,1,916,92,1008,1756650367.4610565,1756650368.9549541,1.4938976764678955
661,rephrase_question,1,0,0,0,1756650726.5913486,1756650726.5914838,0.00013518333435058594
662,intent_identification,1,735,76,811,1756650726.5916398,1756650729.1352139,2.543574094772339
663,column_identification,1,927,111,1038,1756650729.136466,1756650730.9034858,1.7670197486877441
664,rephrase_question,1,0,0,0,1756650833.3165452,1756650833.3166554,0.00011014938354492188
665,intent_identification,1,742,70,812,1756650833.3167608,1756650834.6717157,1.3549549579620361
666,column_identification,1,938,120,1058,1756650834.6721616,1756650836.536757,1.8645954132080078
667,rephrase_question,1,0,0,0,1756650909.639187,1756650909.639271,8.392333984375e-05
668,intent_identification,1,739,65,804,1756650909.6394389,1756650910.890987,1.2515480518341064
669,column_identification,1,930,102,1032,1756650910.8911977,1756650912.4269571,1.535759449005127
670,rephrase_question,1,0,0,0,1756650936.6179633,1756650936.6180727,0.00010943412780761719
671,intent_identification,1,739,65,804,1756650936.6181638,1756650937.8624988,1.2443349361419678
672,column_identification,1,930,109,1039,1756650937.862939,1756650939.531743,1.6688041687011719
673,rephrase_question,1,0,0,0,1756651047.5387194,1756651047.5388277,0.00010824203491210938
674,intent_identification,1,742,57,799,1756651047.5389152,1756651048.6035774,1.064662218093872
675,column_identification,1,915,92,1007,1756651048.6039734,1756651050.0184124,1.4144389629364014
676,rephrase_question,1,0,0,0,1756651150.016508,1756651150.017004,0.00049591064453125
677,intent_identification,1,732,42,774,1756651150.0173109,1756651150.953228,0.9359171390533447
678,column_identification,1,900,69,969,1756651150.9536948,1756651152.34558,1.3918852806091309
679,rephrase_question,1,0,0,0,1756651204.6651802,1756651204.665319,0.00013875961303710938
680,intent_identification,1,731,53,784,1756651204.6661015,1756651205.7620375,1.0959360599517822
681,column_identification,1,901,79,980,1756651205.7628038,1756651207.1176155,1.354811668395996
682,rephrase_question,1,0,0,0,1756651255.2128441,1756651255.2130666,0.0002224445343017578
683,intent_identification,1,738,73,811,1756651255.2132113,1756651256.597679,1.384467601776123
684,column_identification,1,937,120,1057,1756651256.5983348,1756651258.4153728,1.8170380592346191
685,rephrase_question,1,0,0,0,1756651326.4174447,1756651326.417525,8.034706115722656e-05
686,intent_identification,1,737,106,843,1756651326.4180467,1756651328.6586726,2.2406258583068848
687,column_identification,1,956,166,1122,1756651328.6589344,1756651330.9694927,2.310558319091797
688,rephrase_question,1,0,0,0,1756651406.1196322,1756651406.1197731,0.00014090538024902344
689,intent_identification,1,742,93,835,1756651406.1199224,1756651407.64828,1.5283575057983398
690,column_identification,1,961,171,1132,1756651407.6489959,1756651409.9309762,2.281980276107788
691,rephrase_question,1,0,0,0,1756705880.3441737,1756705880.3456273,0.0014536380767822266
692,intent_identification,1,742,106,848,1756705880.3460371,1756705883.0886536,2.7426164150238037
693,column_identification,1,965,185,1150,1756705883.0894306,1756705885.8333988,2.7439682483673096
694,rephrase_question,1,0,0,0,1756705984.8362527,1756705984.8365486,0.00029587745666503906
695,intent_identification,1,742,47,789,1756705984.8370821,1756705986.0829978,1.2459156513214111
696,column_identification,1,919,92,1011,1756705986.0850017,1756705987.6149805,1.5299787521362305
697,rephrase_question,1,0,0,0,1756706063.3700676,1756706063.3720796,0.002012014389038086
698,intent_identification,1,742,47,789,1756706063.3727221,1756706066.1555297,2.7828075885772705
699,column_identification,1,922,92,1014,1756706066.1563463,1756706067.793888,1.6375417709350586
700,rephrase_question,1,0,0,0,1756706323.2790666,1756706323.2816994,0.0026328563690185547
701,intent_identification,1,742,47,789,1756706323.2823026,1756706326.1101654,2.8278627395629883
702,column_identification,1,962,83,1045,1756706326.1106503,1756706327.8840635,1.7734131813049316
703,rephrase_question,1,0,0,0,1756709377.0859761,1756709377.0868874,0.0009112358093261719
704,intent_identification,1,744,116,860,1756709377.0876324,1756709380.2277787,3.140146255493164
705,column_identification,1,1033,200,1233,1756709380.2289014,1756709382.942625,2.713723659515381
706,rephrase_question,1,0,0,0,1756709661.3619082,1756709661.3637686,0.0018603801727294922
707,intent_identification,1,744,117,861,1756709661.3642654,1756709663.620828,2.2565624713897705
708,column_identification,1,1036,196,1232,1756709663.621126,1756709666.2154453,2.5943193435668945
709,rephrase_question,1,0,0,0,1756710182.8736548,1756710182.8739269,0.0002720355987548828
710,intent_identification,1,731,47,778,1756710182.874537,1756710184.1077201,1.2331831455230713
711,column_identification,1,953,74,1027,1756710184.1086895,1756710185.5416892,1.432999610900879
712,rephrase_question,1,0,0,0,1756710255.3983827,1756710255.3986294,0.0002467632293701172
713,intent_identification,1,730,47,777,1756710255.3989723,1756710256.5715601,1.1725878715515137
714,column_identification,1,952,79,1031,1756710256.5725014,1756710258.1401098,1.56760835647583
715,rephrase_question,1,0,0,0,1756710523.0563745,1756710523.0566044,0.00022983551025390625
716,intent_identification,1,730,43,773,1756710523.0608718,1756710524.1688597,1.107987880706787
717,column_identification,1,948,80,1028,1756710524.1698864,1756710525.7818186,1.6119322776794434
718,rephrase_question,1,0,0,0,1756710596.5373719,1756710596.5405385,0.003166675567626953
719,intent_identification,1,730,80,810,1756710596.5410118,1756710598.7118742,2.1708624362945557
720,column_identification,1,983,110,1093,1756710598.7126157,1756710600.6626303,1.950014591217041
721,rephrase_question,1,0,0,0,1756710810.6901252,1756710810.69276,0.002634763717651367
722,intent_identification,1,730,69,799,1756710810.693166,1756710812.418535,1.7253689765930176
723,column_identification,1,983,96,1079,1756710812.4192379,1756710813.9559505,1.536712646484375
724,rephrase_question,1,0,0,0,1756710892.0536554,1756710892.0548453,0.0011899471282958984
725,intent_identification,1,730,69,799,1756710892.0553935,1756710893.5219998,1.4666063785552979
726,column_identification,1,983,116,1099,1756710893.5228453,1756710895.2598166,1.736971378326416
727,rephrase_question,1,0,0,0,1756710960.8093562,1756710960.8095813,0.000225067138671875
728,intent_identification,1,728,68,796,1756710960.8106396,1756710962.2317953,1.4211556911468506
729,column_identification,1,980,111,1091,1756710962.234093,1756710964.0782628,1.8441698551177979
730,rephrase_question,1,0,0,0,1756711170.1159792,1756711170.119125,0.0031456947326660156
731,intent_identification,1,728,78,806,1756711170.121308,1756711172.1861396,2.064831495285034
732,column_identification,1,1017,105,1122,1756711172.187898,1756711173.900737,1.712839126586914
733,rephrase_question,1,0,0,0,1756711206.3803859,1756711206.3806057,0.00021982192993164062
734,intent_identification,1,731,79,810,1756711206.389112,1756711207.8853931,1.4962811470031738
735,column_identification,1,1021,110,1131,1756711207.8861527,1756711209.6249948,1.7388420104980469
736,rephrase_question,1,0,0,0,1756711257.3428526,1756711257.3433173,0.0004646778106689453
737,intent_identification,1,729,68,797,1756711257.353247,1756711258.772946,1.41969895362854
738,column_identification,1,1019,120,1139,1756711258.7738419,1756711260.648746,1.8749041557312012
739,rephrase_question,1,0,0,0,1756711509.663872,1756711509.6671069,0.00323486328125
740,intent_identification,1,731,68,799,1756711509.6690323,1756711511.5178163,1.8487839698791504
741,column_identification,1,1021,107,1128,1756711511.5184298,1756711513.3349743,1.816544532775879
742,rephrase_question,1,0,0,0,1756711806.2386281,1756711806.240615,0.0019867420196533203
743,intent_identification,1,731,79,810,1756711806.2410069,1756711808.0004168,1.7594099044799805
744,column_identification,1,1072,112,1184,1756711808.0014353,1756711809.7768211,1.775385856628418
745,rephrase_question,1,0,0,0,1756713041.7008698,1756713041.7027962,0.001926422119140625
746,intent_identification,1,731,69,800,1756713041.7031324,1756713043.3703434,1.6672110557556152
747,column_identification,1,1073,100,1173,1756713043.3709347,1756713045.1122627,1.7413280010223389
748,rephrase_question,1,0,0,0,1756713045.1710901,1756713045.1713958,0.0003056526184082031
749,intent_identification,1,730,68,798,1756713045.1717253,1756713046.5414572,1.3697319030761719
750,column_identification,1,1071,115,1186,1756713046.5423808,1756713048.4860544,1.9436736106872559
751,rephrase_question,1,0,0,0,1756713048.539467,1756713048.5396655,0.0001983642578125
752,intent_identification,1,728,78,806,1756713048.5401495,1756713050.5422862,2.002136707305908
753,column_identification,1,1068,109,1177,1756713050.5430536,1756713053.199759,2.656705379486084
754,rephrase_question,1,0,0,0,1756713053.2481198,1756713053.2484083,0.0002884864807128906
755,intent_identification,1,731,80,811,1756713053.2488837,1756713054.7057927,1.456908941268921
756,column_identification,1,1073,116,1189,1756713054.7065177,1756713056.577575,1.8710572719573975
757,rephrase_question,1,0,0,0,1756713056.6276727,1756713056.6278584,0.0001857280731201172
758,intent_identification,1,729,68,797,1756713056.6284702,1756713058.113488,1.4850177764892578
759,column_identification,1,1070,125,1195,1756713058.1144013,1756713059.9441495,1.8297481536865234
760,rephrase_question,1,0,0,0,1756718163.1956296,1756718163.1958559,0.0002262592315673828
761,intent_identification,1,732,44,776,1756718163.1961927,1756718165.6577804,2.46158766746521
762,column_identification,1,1049,74,1123,1756718165.658622,1756718167.1937783,1.53515625
763,rephrase_question,1,0,0,0,1756718167.228108,1756718167.2284782,0.00037026405334472656
764,intent_identification,1,729,66,795,1756718167.229021,1756718168.479597,1.2505760192871094
765,column_identification,1,1068,110,1178,1756718168.480137,1756718170.26747,1.7873327732086182
766,rephrase_question,1,0,0,0,1756718170.328323,1756718170.3286452,0.0003223419189453125
767,intent_identification,1,729,72,801,1756718170.3293226,1756718171.70381,1.3744874000549316
768,column_identification,1,1074,124,1198,1756718171.705369,1756718173.6479576,1.9425885677337646
769,rephrase_question,1,0,0,0,1756718173.7004802,1756718173.7007837,0.00030350685119628906
770,intent_identification,1,729,80,809,1756718173.7013052,1756718175.1131203,1.4118151664733887
771,column_identification,1,1071,120,1191,1756718175.1151993,1756718176.9222577,1.807058334350586
772,rephrase_question,1,0,0,0,1756718176.9846208,1756718176.9848719,0.0002510547637939453
773,intent_identification,1,731,69,800,1756718176.9855654,1756718178.3602762,1.3747107982635498
774,column_identification,1,1073,121,1194,1756718178.3621533,1756718180.1992261,1.8370728492736816
775,rephrase_question,1,0,0,0,1756718180.2550468,1756718180.2552626,0.00021576881408691406
776,intent_identification,1,732,70,802,1756718180.255851,1756718181.534666,1.2788150310516357
777,column_identification,1,1075,118,1193,1756718181.53647,1756718183.381542,1.8450720310211182
778,rephrase_question,1,0,0,0,1756718183.4512022,1756718183.4514725,0.0002703666687011719
779,intent_identification,1,732,68,800,1756718183.4522936,1756718184.706854,1.2545604705810547
780,column_identification,1,1073,114,1187,1756718184.709325,1756718186.4568136,1.7474884986877441
781,rephrase_question,1,0,0,0,1756718186.5155616,1756718186.5157928,0.00023126602172851562
782,intent_identification,1,731,53,784,1756718186.5162303,1756718187.7863882,1.270157814025879
783,column_identification,1,1048,80,1128,1756718187.7881238,1756718189.1181822,1.3300583362579346
784,rephrase_question,1,0,0,0,1756718998.3589454,1756718998.3591316,0.0001862049102783203
785,intent_identification,1,728,105,833,1756718998.3595145,1756719000.2108037,1.8512892723083496
786,column_identification,1,1093,138,1231,1756719000.211614,1756719002.559272,2.347658157348633
787,rephrase_question,1,0,0,0,1756719002.5919125,1756719002.5921397,0.00022721290588378906
788,intent_identification,1,729,114,843,1756719002.5924993,1756719004.4035878,1.8110885620117188
789,column_identification,1,1116,151,1267,1756719004.404687,1756719006.6609046,2.2562177181243896
790,rephrase_question,1,0,0,0,1756719090.4867532,1756719090.4891407,0.002387523651123047
791,intent_identification,1,729,44,773,1756719090.4899108,1756719092.8731594,2.3832485675811768
792,column_identification,1,1046,75,1121,1756719092.8738642,1756719094.2032347,1.3293704986572266
793,rephrase_question,1,0,0,0,1756719094.2550814,1756719094.2553587,0.0002772808074951172
794,intent_identification,1,731,69,800,1756719094.2558575,1756719095.5734892,1.317631721496582
795,column_identification,1,1073,130,1203,1756719095.5741673,1756719097.5836608,2.009493589401245
796,rephrase_question,1,0,0,0,1756719097.6348352,1756719097.6351156,0.0002803802490234375
797,intent_identification,1,733,44,777,1756719097.635897,1756719098.7126284,1.0767314434051514
798,column_identification,1,1050,80,1130,1756719098.714497,1756719100.1113756,1.3968784809112549
799,rephrase_question,1,0,0,0,1756719100.160671,1756719100.1608965,0.00022554397583007812
800,intent_identification,1,732,68,800,1756719100.161528,1756719101.4763842,1.3148560523986816
801,column_identification,1,1073,114,1187,1756719101.4774108,1756719103.2170029,1.7395920753479004
802,rephrase_question,1,0,0,0,1756719103.2590055,1756719103.2592857,0.00028014183044433594
803,intent_identification,1,732,80,812,1756719103.2597175,1756719104.85487,1.5951526165008545
804,column_identification,1,1074,120,1194,1756719104.8555894,1756719106.6984224,1.8428330421447754
805,rephrase_question,1,0,0,0,1756719106.743623,1756719106.7438982,0.0002751350402832031
806,intent_identification,1,733,95,828,1756719106.7444444,1756719108.3854947,1.6410503387451172
807,column_identification,1,1101,168,1269,1756719108.3867536,1756719110.7930973,2.406343698501587
808,rephrase_question,1,0,0,0,1756719110.8437269,1756719110.8439658,0.00023889541625976562
809,intent_identification,1,730,65,795,1756719110.8446407,1756719112.123315,1.2786743640899658
810,column_identification,1,1068,119,1187,1756719112.123945,1756719114.7868292,2.66288423538208
811,rephrase_question,1,0,0,0,1756719114.8385968,1756719114.8388577,0.0002608299255371094
812,intent_identification,1,729,89,818,1756719114.8392613,1756719116.4256656,1.5864043235778809
813,column_identification,1,1091,162,1253,1756719116.4263442,1756719118.7872946,2.360950469970703
814,rephrase_question,1,0,0,0,1756719715.6638722,1756719715.6651404,0.001268148422241211
815,intent_identification,1,728,101,829,1756719715.6653037,1756719717.5701776,1.9048738479614258
816,column_identification,1,1090,162,1252,1756719717.5703459,1756719719.86462,2.294274091720581
817,rephrase_question,1,0,0,0,1756719719.879406,1756719719.879484,7.796287536621094e-05
818,intent_identification,1,729,101,830,1756719719.8796246,1756719721.5245688,1.644944190979004
819,column_identification,1,1091,149,1240,1756719721.5248535,1756719723.6562653,2.1314117908477783
820,rephrase_question,1,0,0,0,1756719723.6756783,1756719723.675754,7.581710815429688e-05
821,intent_identification,1,734,112,846,1756719723.675932,1756719725.503931,1.8279991149902344
822,column_identification,1,1119,265,1384,1756719725.5047433,1756719728.7450185,3.2402751445770264
823,rephrase_question,1,0,0,0,1756719728.7668726,1756719728.7669806,0.00010800361633300781
824,intent_identification,1,730,92,822,1756719728.767145,1756719730.2555964,1.4884514808654785
825,column_identification,1,1095,165,1260,1756719730.255875,1756719732.569004,2.31312894821167
826,rephrase_question,1,0,0,0,1756719732.5884178,1756719732.5884902,7.2479248046875e-05
827,intent_identification,1,733,89,822,1756719732.5886667,1756719734.1329622,1.5442955493927002
828,column_identification,1,1095,122,1217,1756719734.1333392,1756719735.9871078,1.8537685871124268
829,rephrase_question,1,0,0,0,1756719736.0050967,1756719736.0051725,7.581710815429688e-05
830,intent_identification,1,730,68,798,1756719736.0055363,1756719737.1793861,1.1738498210906982
831,column_identification,1,1071,121,1192,1756719737.179869,1756719738.9048138,1.724944829940796
832,rephrase_question,1,0,0,0,1756720164.072983,1756720164.073722,0.0007388591766357422
833,intent_identification,1,731,97,828,1756720164.073862,1756720166.9073331,2.8334710597991943
834,column_identification,1,1101,176,1277,1756720166.9076018,1756720169.2160218,2.308419942855835
835,rephrase_question,1,0,0,0,1756720169.2299914,1756720169.2300737,8.225440979003906e-05
836,intent_identification,1,732,89,821,1756720169.230366,1756720170.6429682,1.412602186203003
837,column_identification,1,1094,163,1257,1756720170.6437776,1756720172.8248384,2.181060791015625
838,rephrase_question,1,0,0,0,1756720172.8481991,1756720172.8482914,9.226799011230469e-05
839,intent_identification,1,731,74,805,1756720172.8485188,1756720174.4328828,1.5843639373779297
840,column_identification,1,1068,111,1179,1756720174.4339907,1756720176.1772091,1.7432184219360352
841,rephrase_question,1,0,0,0,1756720176.2296865,1756720176.2299914,0.00030493736267089844
842,intent_identification,1,727,72,799,1756720176.230766,1756720177.50568,1.274914026260376
843,column_identification,1,1062,138,1200,1756720177.5064332,1756720179.424768,1.918334722518921
844,rephrase_question,1,0,0,0,1756720179.4701452,1756720179.470265,0.00011968612670898438
845,intent_identification,1,728,93,821,1756720179.4705606,1756720181.0906875,1.6201269626617432
846,column_identification,1,1094,162,1256,1756720181.0920274,1756720183.3357158,2.2436883449554443
847,rephrase_question,1,0,0,0,1756720183.3915358,1756720183.3922412,0.0007054805755615234
848,intent_identification,1,727,66,793,1756720183.3927264,1756720184.7042263,1.311499834060669
849,column_identification,1,1066,115,1181,1756720184.7049203,1756720186.4842134,1.7792930603027344
850,rephrase_question,1,0,0,0,1756720186.5149868,1756720186.5152013,0.00021457672119140625
851,intent_identification,1,728,90,818,1756720186.5164363,1756720188.0419497,1.5255134105682373
852,column_identification,1,1091,166,1257,1756720188.0435212,1756720190.3309548,2.287433624267578
853,rephrase_question,1,0,0,0,1756720190.3767717,1756720190.3769233,0.00015163421630859375
854,intent_identification,1,729,66,795,1756720190.3772798,1756720191.723886,1.3466062545776367
855,column_identification,1,1068,119,1187,1756720191.725937,1756720193.5264955,1.8005585670471191
856,rephrase_question,1,0,0,0,1756720620.9849846,1756720620.9857032,0.0007185935974121094
857,intent_identification,1,731,87,818,1756720620.9857798,1756720623.9314644,2.9456846714019775
858,column_identification,1,1091,128,1219,1756720623.931698,1756720625.8833869,1.9516887664794922
859,rephrase_question,1,0,0,0,1756720625.8969855,1756720625.8971179,0.0001323223114013672
860,intent_identification,1,730,89,819,1756720625.8974783,1756720627.4894016,1.5919232368469238
861,column_identification,1,1092,175,1267,1756720627.4895952,1756720629.8572881,2.3676929473876953
862,rephrase_question,1,0,0,0,1756720629.8763335,1756720629.8764079,7.43865966796875e-05
863,intent_identification,1,728,83,811,1756720629.876697,1756720631.1931841,1.3164870738983154
864,column_identification,1,1084,183,1267,1756720631.193574,1756720633.5485988,2.355024814605713
865,rephrase_question,1,0,0,0,1756720633.5733244,1756720633.5734496,0.0001251697540283203
866,intent_identification,1,731,90,821,1756720633.5737827,1756720635.1094701,1.5356874465942383
867,column_identification,1,1094,165,1259,1756720635.109912,1756720637.4052293,2.2953174114227295
868,rephrase_question,1,0,0,0,1756720637.4240487,1756720637.424123,7.43865966796875e-05
869,intent_identification,1,731,61,792,1756720637.4245253,1756720639.4377594,2.0132341384887695
870,column_identification,1,1065,92,1157,1756720639.4382505,1756720640.8650463,1.4267957210540771
871,rephrase_question,1,0,0,0,1756720640.8849752,1756720640.885035,5.984306335449219e-05
872,intent_identification,1,729,53,782,1756720640.8851814,1756720641.9081326,1.0229511260986328
873,column_identification,1,1055,97,1152,1756720641.9083698,1756720643.4497883,1.5414185523986816
874,rephrase_question,1,0,0,0,1756720643.4724512,1756720643.472598,0.0001468658447265625
875,intent_identification,1,729,63,792,1756720643.4729052,1756720644.5904617,1.1175565719604492
876,column_identification,1,1055,107,1162,1756720644.591031,1756720646.0995944,1.5085632801055908
877,rephrase_question,1,0,0,0,1756720648.6388128,1756720648.6390133,0.00020051002502441406
878,intent_identification,1,730,80,810,1756720648.6391954,1756720649.9555786,1.3163831233978271
879,column_identification,1,1083,120,1203,1756720649.9567087,1756720651.6501746,1.6934659481048584
880,rephrase_question,1,0,0,0,1756720881.459649,1756720881.4597495,0.00010037422180175781
881,intent_identification,1,731,78,809,1756720881.4600945,1756720882.7381043,1.2780098915100098
882,column_identification,1,1082,144,1226,1756720882.738435,1756720884.6054697,1.867034673690796
883,rephrase_question,1,0,0,0,1756720884.6210332,1756720884.6211112,7.796287536621094e-05
884,intent_identification,1,729,72,801,1756720884.6212363,1756720885.856211,1.2349746227264404
885,column_identification,1,1063,105,1168,1756720885.8576005,1756720887.3670344,1.5094339847564697
886,rephrase_question,1,0,0,0,1756720887.386948,1756720887.38706,0.00011181831359863281
887,intent_identification,1,732,63,795,1756720887.3872392,1756720888.482236,1.094996690750122
888,column_identification,1,1058,112,1170,1756720888.4830334,1756720890.09191,1.6088764667510986
889,rephrase_question,1,0,0,0,1756721079.4847138,1756721079.4860709,0.0013570785522460938
890,intent_identification,1,728,78,806,1756721079.4866383,1756721082.228582,2.741943597793579
891,column_identification,1,1068,150,1218,1756721082.228875,1756721084.311765,2.082890033721924
892,rephrase_question,1,0,0,0,1756721084.3278468,1756721084.327966,0.00011920928955078125
893,intent_identification,1,728,63,791,1756721084.3281143,1756721085.5344114,1.2062971591949463
894,column_identification,1,1054,101,1155,1756721085.5348687,1756721087.0104883,1.4756195545196533
895,rephrase_question,1,0,0,0,1756721087.0294645,1756721087.029526,6.151199340820312e-05
896,intent_identification,1,732,66,798,1756721087.029608,1756721088.2102683,1.1806602478027344
897,column_identification,1,1071,125,1196,1756721088.2110345,1756721089.8515048,1.640470266342163
898,rephrase_question,1,0,0,0,1756725813.053191,1756725813.053348,0.0001571178436279297
899,intent_identification,1,724,53,777,1756725813.0546856,1756725814.8588958,1.8042101860046387
900,column_identification,1,1042,80,1122,1756725814.8594925,1756725816.204494,1.345001459121704
901,rephrase_question,1,0,0,0,1756725816.267062,1756725816.2672231,0.00016117095947265625
902,intent_identification,1,724,5,729,1756725816.2677944,1756725816.8571239,0.5893294811248779
903,column_identification,1,1007,16,1023,1756725816.8582704,1756725818.2193274,1.3610570430755615
904,rephrase_question,1,0,0,0,1756725987.060298,1756725987.062479,0.0021810531616210938
905,intent_identification,1,724,53,777,1756725987.0630727,1756725989.6315334,2.568460702896118
906,column_identification,1,1042,80,1122,1756725989.6321392,1756725990.9022017,1.2700624465942383
907,rephrase_question,1,0,0,0,1756725990.9494221,1756725990.949589,0.00016689300537109375
908,intent_identification,1,724,16,740,1756725990.9501002,1756725991.5956101,0.6455099582672119
909,column_identification,1,1015,16,1031,1756725991.5965548,1756725992.8083265,1.2117717266082764
910,rephrase_question,1,0,0,0,1756725992.858304,1756725992.8586407,0.00033664703369140625
911,intent_identification,1,724,16,740,1756725992.8590887,1756725993.526724,0.667635440826416
912,column_identification,1,1015,16,1031,1756725993.5273645,1756725994.7542377,1.2268731594085693
913,rephrase_question,1,0,0,0,1756725994.8011422,1756725994.8012974,0.0001552104949951172
914,intent_identification,1,724,16,740,1756725994.8018532,1756725995.6584885,0.856635332107544
915,column_identification,1,1015,16,1031,1756725995.6589627,1756725996.6979396,1.0389769077301025
916,rephrase_question,1,0,0,0,1756725996.734474,1756725996.7346368,0.0001628398895263672
917,intent_identification,1,723,53,776,1756725996.7350972,1756725997.932766,1.1976687908172607
918,column_identification,1,1041,80,1121,1756725997.9336085,1756725999.3619268,1.4283182621002197
919,rephrase_question,1,0,0,0,1756725999.4125726,1756725999.4127154,0.00014281272888183594
920,intent_identification,1,724,13,737,1756725999.4132442,1756726000.1807597,0.7675154209136963
921,column_identification,1,1015,16,1031,1756726000.1815562,1756726001.307763,1.126206874847412
922,rephrase_question,1,0,0,0,1756726001.3467155,1756726001.3468456,0.00013017654418945312
923,intent_identification,1,724,16,740,1756726001.3472922,1756726002.0651968,0.7179045677185059
924,column_identification,1,1015,16,1031,1756726002.0660274,1756726003.2224205,1.156393051147461
925,rephrase_question,1,0,0,0,1756726003.264981,1756726003.265191,0.00021004676818847656
926,intent_identification,1,724,16,740,1756726003.2657397,1756726003.95976,0.6940202713012695
927,column_identification,1,1015,16,1031,1756726003.9604428,1756726005.1764467,1.2160038948059082
928,rephrase_question,1,0,0,0,1756726195.181138,1756726195.1813037,0.00016570091247558594
929,intent_identification,1,724,53,777,1756726195.1816661,1756726196.784842,1.6031758785247803
930,column_identification,1,1042,80,1122,1756726196.785617,1756726198.2214766,1.4358594417572021
931,rephrase_question,1,0,0,0,1756727221.473978,1756727221.476267,0.0022890567779541016
932,intent_identification,1,724,53,777,1756727221.476919,1756727223.4725235,1.9956045150756836
933,column_identification,1,1042,80,1122,1756727223.4730444,1756727224.868282,1.395237684249878
934,rephrase_question,1,0,0,0,1756727224.9186757,1756727224.9188535,0.00017786026000976562
935,intent_identification,1,724,16,740,1756727224.9191852,1756727225.5935147,0.6743295192718506
936,column_identification,1,1015,16,1031,1756727225.5940683,1756727227.5462623,1.9521939754486084
937,rephrase_question,1,0,0,0,1756727227.59875,1756727227.5989113,0.00016117095947265625
938,intent_identification,1,724,16,740,1756727227.5993738,1756727230.502106,2.9027321338653564
939,column_identification,1,1015,16,1031,1756727230.5025403,1756727231.2906265,0.7880861759185791
940,rephrase_question,1,0,0,0,1756727231.3355799,1756727231.3357735,0.00019359588623046875
941,intent_identification,1,724,16,740,1756727231.3362072,1756727232.344793,1.0085859298706055
942,column_identification,1,1015,16,1031,1756727232.3454978,1756727233.5249019,1.1794040203094482
943,rephrase_question,1,0,0,0,1756727233.5750186,1756727233.575261,0.00024247169494628906
944,intent_identification,1,723,44,767,1756727233.5756366,1756727234.599421,1.0237843990325928
945,column_identification,1,1041,80,1121,1756727234.6004431,1756727236.1316686,1.5312254428863525
946,rephrase_question,1,0,0,0,1756727236.1795979,1756727236.1797853,0.00018739700317382812
947,intent_identification,1,724,16,740,1756727236.1801052,1756727236.950387,0.7702817916870117
948,column_identification,1,1015,16,1031,1756727236.9516585,1756727238.0789819,1.1273233890533447
949,rephrase_question,1,0,0,0,1756727238.1197636,1756727238.119961,0.00019741058349609375
950,intent_identification,1,724,5,729,1756727238.1207469,1756727238.6579142,0.5371673107147217
951,column_identification,1,1007,16,1023,1756727238.6587715,1756727240.774223,2.1154515743255615
952,rephrase_question,1,0,0,0,1756727240.8174322,1756727240.8176277,0.00019550323486328125
953,intent_identification,1,724,16,740,1756727240.8180828,1756727242.4833813,1.6652984619140625
954,column_identification,1,1015,16,1031,1756727242.4841583,1756727243.1434717,0.659313440322876
955,rephrase_question,1,0,0,0,1756728421.7991693,1756728421.8026848,0.003515481948852539
956,intent_identification,1,730,79,809,1756728421.8031135,1756728424.882187,3.079073429107666
957,column_identification,1,1071,115,1186,1756728424.8828034,1756728426.8247077,1.9419043064117432
958,rephrase_question,1,0,0,0,1756728426.8725784,1756728426.8729136,0.0003352165222167969
959,intent_identification,1,728,71,799,1756728426.8734453,1756728428.3601482,1.4867029190063477
960,column_identification,1,1072,114,1186,1756728428.3610024,1756728430.100107,1.7391045093536377
961,rephrase_question,1,0,0,0,1756728430.1505322,1756728430.1507797,0.0002474784851074219
962,intent_identification,1,731,68,799,1756728430.151215,1756728431.9394805,1.7882654666900635
963,column_identification,1,1072,110,1182,1756728431.9402094,1756728433.6993897,1.7591803073883057
964,rephrase_question,1,0,0,0,1756730040.8226693,1756730040.8253849,0.002715587615966797
965,intent_identification,1,730,68,798,1756730040.825992,1756730042.7234693,1.897477149963379
966,column_identification,1,1071,111,1182,1756730042.7246122,1756730044.5640495,1.8394372463226318
967,sql_generation,1,896,101,997,1756730044.5646248,1756730046.3081062,1.7434813976287842
968,sql_execution,1,0,0,0,1756730046.331839,1756730047.0368652,0.7050261497497559
969,rephrase_question,1,0,0,0,1756730047.0878766,1756730047.0881183,0.00024175643920898438
970,intent_identification,1,728,73,801,1756730047.088752,1756730048.5571206,1.4683685302734375
971,column_identification,1,1074,112,1186,1756730048.5577605,1756730050.2923923,1.7346317768096924
972,sql_generation,1,900,95,995,1756730050.2931492,1756730051.9361396,1.6429903507232666
973,sql_execution,1,0,0,0,1756730051.9367285,1756730052.0331836,0.09645509719848633
974,rephrase_question,1,0,0,0,1756730052.0804536,1756730052.0807023,0.0002486705780029297
975,intent_identification,1,731,72,803,1756730052.0812235,1756730053.4229863,1.3417627811431885
976,column_identification,1,1076,111,1187,1756730053.4238796,1756730055.1583328,1.7344532012939453
977,sql_generation,1,901,117,1018,1756730055.1590877,1756730056.9579551,1.7988674640655518
978,sql_execution,1,0,0,0,1756730056.958726,1756730057.0330138,0.07428789138793945
979,rephrase_question,1,0,0,0,1756730253.8784056,1756730253.8803952,0.001989603042602539
980,intent_identification,1,724,53,777,1756730253.8809948,1756730255.3556633,1.4746685028076172
981,column_identification,1,1042,80,1122,1756730255.3562133,1756730256.8348572,1.4786438941955566
982,sql_generation,1,841,38,879,1756730256.8355064,1756730258.3703215,1.5348150730133057
983,sql_execution,1,0,0,0,1756730258.3711386,1756730259.347338,0.9761993885040283
984,rephrase_question,1,0,0,0,1756730259.411709,1756730259.4119244,0.00021529197692871094
985,intent_identification,1,724,5,729,1756730259.4125047,1756730260.1116142,0.6991095542907715
986,column_identification,1,1007,16,1023,1756730260.1122427,1756730261.441859,1.3296163082122803
987,sql_generation,1,759,17,776,1756730261.4423559,1756730262.1963825,0.7540266513824463
988,sql_execution,1,0,0,0,1756730262.1976118,1756730262.2775173,0.07990550994873047
989,rephrase_question,1,0,0,0,1756730570.7268457,1756730570.7287133,0.001867532730102539
990,intent_identification,1,724,13,737,1756730570.7291956,1756730572.1261718,1.3969762325286865
991,column_identification,1,1015,16,1031,1756730572.1269898,1756730573.0423517,0.9153618812561035
992,sql_generation,1,767,6,773,1756730573.042642,1756730573.9635944,0.920952320098877
993,sql_execution,1,0,0,0,1756730573.9646957,1756730574.3894343,0.42473864555358887
994,rephrase_question,1,0,0,0,1756730574.4419212,1756730574.4420917,0.0001704692840576172
995,intent_identification,1,724,16,740,1756730574.4427142,1756730575.2004066,0.7576923370361328
996,column_identification,1,1015,16,1031,1756730575.2012265,1756730576.419723,1.218496561050415
997,sql_generation,1,767,17,784,1756730576.4204252,1756730577.1027246,0.6822993755340576
998,sql_execution,1,0,0,0,1756730577.1035922,1756730577.1825645,0.07897233963012695
999,rephrase_question,1,0,0,0,1756730577.2325964,1756730577.2327714,0.00017499923706054688
1000,intent_identification,1,724,16,740,1756730577.2332513,1756730578.2460601,1.0128087997436523
1001,column_identification,1,1015,16,1031,1756730578.246708,1756730579.2885723,1.0418643951416016
1002,sql_generation,1,767,17,784,1756730579.2893014,1756730580.1093314,0.8200299739837646
1003,sql_execution,1,0,0,0,1756730580.1101034,1756730580.1917694,0.0816659927368164
1004,rephrase_question,1,0,0,0,1756730580.2576287,1756730580.2578027,0.00017404556274414062
1005,intent_identification,1,724,16,740,1756730580.2582371,1756730581.088567,0.8303298950195312
1006,column_identification,1,1015,16,1031,1756730581.0896804,1756730582.238396,1.1487154960632324
1007,sql_generation,1,767,6,773,1756730582.239081,1756730582.9738047,0.7347238063812256
1008,sql_execution,1,0,0,0,1756730582.975103,1756730583.0535984,0.07849550247192383
1009,rephrase_question,1,0,0,0,1756730583.108465,1756730583.1090467,0.0005817413330078125
1010,intent_identification,1,724,13,737,1756730583.10964,1756730584.0995002,0.9898602962493896
1011,column_identification,1,1015,16,1031,1756730584.1004362,1756730585.095811,0.9953746795654297
1012,sql_generation,1,767,13,780,1756730585.0964363,1756730586.0905204,0.9940841197967529
1013,sql_execution,1,0,0,0,1756730586.0910444,1756730586.1829076,0.09186315536499023
1014,rephrase_question,1,0,0,0,1756730586.231386,1756730586.23158,0.00019407272338867188
1015,intent_identification,1,723,44,767,1756730586.2321653,1756730587.4793837,1.247218370437622
1016,column_identification,1,1041,80,1121,1756730587.4803674,1756730588.972103,1.4917356967926025
1017,sql_generation,1,840,38,878,1756730588.9741516,1756730590.2594316,1.2852799892425537
1018,sql_execution,1,0,0,0,1756730590.26041,1756730591.4062827,1.1458725929260254
1019,rephrase_question,1,0,0,0,1756730630.6958742,1756730630.696008,0.00013375282287597656
1020,intent_identification,1,724,44,768,1756730630.6963072,1756730632.4300294,1.73372220993042
1021,column_identification,1,1042,80,1122,1756730632.4306538,1756730633.8659446,1.435290813446045
1022,sql_generation,1,841,38,879,1756730633.8667748,1756730635.1968873,1.3301124572753906
1023,sql_execution,1,0,0,0,1756730635.19769,1756730635.9359853,0.738295316696167
1024,rephrase_question,1,0,0,0,1756730635.994774,1756730635.9949553,0.0001811981201171875
1025,intent_identification,1,724,16,740,1756730635.9953816,1756730636.732395,0.7370133399963379
1026,column_identification,1,1014,16,1030,1756730636.7334123,1756730637.9605289,1.227116584777832
1027,sql_generation,1,766,18,784,1756730637.960874,1756730638.6773493,0.716475248336792
1028,sql_execution,1,0,0,0,1756730638.6778026,1756730638.7548997,0.07709717750549316
1029,rephrase_question,1,0,0,0,1756730638.807141,1756730638.807338,0.00019693374633789062
1030,intent_identification,1,724,53,777,1756730638.8078876,1756730640.162056,1.35416841506958
1031,column_identification,1,1042,80,1122,1756730640.1630795,1756730641.6491017,1.4860222339630127
1032,sql_generation,1,841,38,879,1756730641.6498702,1756730642.6465566,0.9966864585876465
1033,sql_execution,1,0,0,0,1756730642.647077,1756730643.3352268,0.6881496906280518
1034,rephrase_question,1,0,0,0,1756730643.3836422,1756730643.383811,0.00016880035400390625
1035,intent_identification,1,724,71,795,1756730643.3842168,1756730644.7198794,1.335662603378296
1036,column_identification,1,1069,167,1236,1756730644.72098,1756730646.972818,2.251837968826294
1037,sql_generation,1,938,147,1085,1756730646.9734359,1756730650.3497534,3.3763175010681152
1038,sql_execution,1,0,0,0,1756730650.350335,1756730650.4259076,0.07557272911071777
1039,rephrase_question,1,0,0,0,1756730650.4766746,1756730650.4769292,0.00025463104248046875
1040,intent_identification,1,724,44,768,1756730650.477529,1756730652.5005417,2.023012638092041
1041,column_identification,1,1042,80,1122,1756730652.501178,1756730653.9338577,1.4326796531677246
1042,sql_generation,1,841,39,880,1756730653.9343514,1756730654.934082,0.9997305870056152
1043,sql_execution,1,0,0,0,1756730654.934842,1756730655.591881,0.6570389270782471
1044,rephrase_question,1,0,0,0,1756805685.10474,1756805685.1060283,0.0012884140014648438
1045,intent_identification,1,749,80,829,1756805685.1067727,1756805688.021718,2.914945363998413
1046,column_identification,1,1091,115,1206,1756805688.0229354,1756805689.814906,1.7919704914093018
1047,sql_generation,1,884,142,1026,1756805689.815332,1756805691.7681153,1.9527833461761475
1048,sql_execution,1,0,0,0,1756805691.768876,1756805692.4797099,0.7108337879180908
1049,rephrase_question,1,0,0,0,1756805798.9034054,1756805798.9044423,0.0010368824005126953
1050,intent_identification,1,749,72,821,1756805798.9046988,1756805801.7162445,2.8115456104278564
1051,column_identification,1,1094,115,1209,1756805801.7178044,1756805803.5014167,1.7836122512817383
1052,sql_generation,1,884,142,1026,1756805803.5026364,1756805805.4579198,1.9552834033966064
1053,sql_execution,1,0,0,0,1756805805.458654,1756805806.1184423,0.6597883701324463
1054,rephrase_question,1,0,0,0,1756805856.5475779,1756805856.5492785,0.0017006397247314453
1055,intent_identification,1,749,69,818,1756805856.5496943,1756805858.132908,1.5832138061523438
1056,column_identification,1,1091,115,1206,1756805858.1331944,1756805859.8607998,1.7276053428649902
1057,sql_generation,1,884,144,1028,1756805859.861453,1756805861.7143252,1.8528721332550049
1058,sql_execution,1,0,0,0,1756805861.714798,1756805862.1931038,0.4783058166503906
1059,rephrase_question,1,0,0,0,1756805929.900128,1756805929.9027297,0.0026018619537353516
1060,intent_identification,1,749,69,818,1756805929.9030259,1756805931.6706817,1.767655849456787
1061,column_identification,1,1091,115,1206,1756805931.671465,1756805933.4572093,1.7857444286346436
1062,sql_generation,1,884,136,1020,1756805933.4579375,1756805935.3743908,1.9164533615112305
1063,sql_execution,1,0,0,0,1756805935.3749545,1756805935.879417,0.504462480545044
1064,rephrase_question,1,0,0,0,1756805987.131381,1756805987.1328938,0.001512765884399414
1065,intent_identification,1,749,80,829,1756805987.13332,1756805988.7930596,1.6597394943237305
1066,column_identification,1,1091,115,1206,1756805988.7938082,1756805990.5181658,1.7243576049804688
1067,sql_generation,1,884,142,1026,1756805990.518913,1756805992.4048328,1.8859198093414307
1068,sql_execution,1,0,0,0,1756805992.4055517,1756805992.8874593,0.48190760612487793
1069,rephrase_question,1,0,0,0,1756806469.310958,1756806469.3133767,0.0024187564849853516
1070,intent_identification,1,731,69,800,1756806469.3138697,1756806472.2821977,2.9683279991149902
1071,column_identification,1,1073,100,1173,1756806472.2831047,1756806473.8777587,1.5946540832519531
1072,sql_generation,1,854,41,895,1756806473.878828,1756806474.9083655,1.0295374393463135
1073,sql_execution,1,0,0,0,1756806474.9093132,1756806476.4565935,1.5472803115844727
1074,rephrase_question,1,0,0,0,1756807270.3252919,1756807270.3262765,0.0009846687316894531
1075,intent_identification,1,731,46,777,1756807270.3269017,1756807271.592455,1.2655532360076904
1076,column_identification,1,1050,74,1124,1756807271.592791,1756807272.913149,1.3203580379486084
1077,sql_generation,1,795,31,826,1756807272.9144142,1756807273.7849052,0.8704910278320312
1078,sql_execution,1,0,0,0,1756807273.7857122,1756807274.2867851,0.501072883605957
1079,rephrase_question,1,0,0,0,1756808780.080173,1756808780.0813532,0.0011801719665527344
1080,intent_identification,1,731,46,777,1756808780.0815756,1756808781.534215,1.4526393413543701
1081,column_identification,1,1050,74,1124,1756808781.5347524,1756808782.8712232,1.3364708423614502
1082,sql_generation,1,795,31,826,1756808782.8719785,1756808783.7787142,0.9067356586456299
1083,sql_execution,1,0,0,0,1756808783.7792823,1756808785.76686,1.9875776767730713
1084,rephrase_question,1,0,0,0,1756808831.0267909,1756808831.0283659,0.0015749931335449219
1085,intent_identification,1,731,47,778,1756808831.0286639,1756808832.420817,1.392153024673462
1086,column_identification,1,1051,75,1126,1756808832.4215055,1756808833.7540066,1.3325011730194092
1087,sql_generation,1,797,39,836,1756808833.7542784,1756808834.6729856,0.9187071323394775
1088,sql_execution,1,0,0,0,1756808834.6734695,1756808836.4738786,1.8004090785980225
1089,rephrase_question,1,0,0,0,1756808869.240427,1756808869.2427003,0.0022733211517333984
1090,intent_identification,1,731,47,778,1756808869.2429397,1756808870.613699,1.3707592487335205
1091,column_identification,1,1051,79,1130,1756808870.6144571,1756808872.2546456,1.640188455581665
1092,sql_generation,1,800,32,832,1756808872.2555168,1756808873.1644077,0.908890962600708
1093,sql_execution,1,0,0,0,1756808873.1646645,1756808874.4219348,1.257270336151123
1094,rephrase_question,1,0,0,0,1756809018.6878974,1756809018.689162,0.0012645721435546875
1095,intent_identification,1,731,51,782,1756809018.6895645,1756809020.1181417,1.428577184677124
1096,column_identification,1,1046,69,1115,1756809020.118471,1756809021.4507086,1.332237720489502
1097,sql_generation,1,809,32,841,1756809021.4512272,1756809022.3722363,0.9210090637207031
1098,sql_execution,1,0,0,0,1756809022.3726842,1756809023.7186613,1.3459770679473877
1099,rephrase_question,1,0,0,0,1756809310.1059613,1756809310.1102862,0.004324913024902344
1100,intent_identification,1,731,47,778,1756809310.1106322,1756809311.8590286,1.748396396636963
1101,column_identification,1,1051,75,1126,1756809311.859731,1756809313.1868007,1.3270697593688965
1102,sql_generation,1,811,33,844,1756809313.187717,1756809314.1102436,0.9225265979766846
1103,sql_execution,1,0,0,0,1756809314.1109138,1756809315.3586836,1.247769832611084
1104,rephrase_question,1,0,0,0,1756809747.3123395,1756809747.3157716,0.003432035446166992
1105,intent_identification,1,731,47,778,1756809747.3200083,1756809750.2362738,2.9162654876708984
1106,column_identification,1,1051,75,1126,1756809750.2366402,1756809751.564763,1.328122854232788
1107,sql_generation,1,811,37,848,1756809751.5666597,1756809752.745513,1.1788532733917236
1108,sql_execution,1,0,0,0,1756809752.7469254,1756809754.7336564,1.9867310523986816
1109,rephrase_question,1,0,0,0,1756819381.7607129,1756819381.7626758,0.001962900161743164
1110,intent_identification,1,731,46,777,1756819381.7633085,1756819384.3449192,2.581610679626465
1111,column_identification,1,1050,74,1124,1756819384.3452988,1756819385.934839,1.5895402431488037
1112,sql_generation,1,809,31,840,1756819385.9351547,1756819386.8681011,0.9329464435577393
1113,sql_execution,1,0,0,0,1756819386.8689618,1756819387.345862,0.4769001007080078
1114,rephrase_question,1,0,0,0,1756820372.1568084,1756820372.1577609,0.0009524822235107422
1115,intent_identification,1,731,47,778,1756820372.1579187,1756820373.4718904,1.313971757888794
1116,column_identification,1,1051,75,1126,1756820373.4728093,1756820374.971661,1.4988517761230469
1117,sql_generation,1,813,32,845,1756820374.9727964,1756820375.898608,0.9258115291595459
1118,sql_execution,1,0,0,0,1756820375.8993583,1756820376.4314985,0.5321402549743652
1119,rephrase_question,1,0,0,0,1756880582.8775022,1756880582.8791878,0.0016856193542480469
1120,intent_identification,1,731,46,777,1756880582.8795657,1756880584.2064588,1.3268930912017822
1121,column_identification,1,1050,74,1124,1756880584.2071936,1756880585.6081781,1.400984525680542
1122,sql_generation,1,809,31,840,1756880585.608894,1756880586.441614,0.8327198028564453
1123,sql_execution,1,0,0,0,1756880586.4424174,1756880586.674204,0.23178672790527344
1124,rephrase_question,1,0,0,0,1756880994.1287417,1756880994.1314337,0.002691984176635742
1125,intent_identification,1,731,47,778,1756880994.1324987,1756880996.7975497,2.665050983428955
1126,column_identification,1,1051,75,1126,1756880996.7981822,1756880998.065816,1.2676336765289307
1127,sql_generation,1,813,37,850,1756880998.0665011,1756880998.987134,0.9206328392028809
1128,sql_execution,1,0,0,0,1756880998.987526,1756880999.1548731,0.16734719276428223
1129,rephrase_question,1,0,0,0,1756882175.0784948,1756882175.0799146,0.0014197826385498047
1130,intent_identification,1,731,70,801,1756882175.0804615,1756882176.7996254,1.7191638946533203
1131,column_identification,1,1074,95,1169,1756882176.8004923,1756882178.401635,1.6011426448822021
1132,sql_generation,1,856,36,892,1756882178.4074674,1756882179.4822652,1.0747978687286377
1133,sql_execution,1,0,0,0,1756882179.4830608,1756882179.8822522,0.39919137954711914
1134,rephrase_question,1,0,0,0,1756882269.776688,1756882269.777947,0.00125885009765625
1135,intent_identification,1,731,47,778,1756882269.7783647,1756882271.0601797,1.2818150520324707
1136,column_identification,1,1051,75,1126,1756882271.0613787,1756882272.512175,1.450796365737915
1137,sql_generation,1,812,31,843,1756882272.5148785,1756882273.4093308,0.8944523334503174
1138,sql_execution,1,0,0,0,1756882273.410207,1756882273.5636833,0.15347623825073242
1139,rephrase_question,1,0,0,0,1756883250.4250038,1756883250.4274213,0.0024175643920898438
1140,intent_identification,1,730,68,798,1756883250.4280007,1756883252.0849414,1.6569406986236572
1141,column_identification,1,1071,111,1182,1756883252.0854874,1756883253.748729,1.6632416248321533
1142,sql_generation,1,868,114,982,1756883253.7535331,1756883255.4055536,1.6520204544067383
1143,sql_execution,1,0,0,0,1756883255.4060266,1756883255.692997,0.2869703769683838
1144,rephrase_question,1,0,0,0,1756883391.608262,1756883391.6083922,0.00013017654418945312
1145,intent_identification,1,728,78,806,1756883391.6086874,1756883393.023455,1.4147675037384033
1146,column_identification,1,1068,110,1178,1756883393.0238621,1756883394.6933193,1.669457197189331
1147,sql_generation,1,866,64,930,1756883394.6979485,1756883396.0251937,1.3272452354431152
1148,sql_execution,1,0,0,0,1756883396.0262008,1756883396.1028552,0.07665443420410156
1149,rephrase_question,1,0,0,0,1756883454.0391152,1756883454.0434434,0.004328250885009766
1150,intent_identification,1,728,79,807,1756883454.0441694,1756883457.2290206,3.1848511695861816
1151,column_identification,1,1069,106,1175,1756883457.2294645,1756883459.5539963,2.3245317935943604
1152,sql_generation,1,863,124,987,1756883459.556306,1756883461.3506124,1.7943065166473389
1153,sql_execution,1,0,0,0,1756883461.351773,1756883461.513271,0.1614980697631836
1154,rephrase_question,1,0,0,0,1756883808.4421735,1756883808.4423656,0.00019216537475585938
1155,intent_identification,1,731,71,802,1756883808.4428232,1756883809.7684197,1.325596570968628
1156,column_identification,1,1075,110,1185,1756883809.7691898,1756883811.5247362,1.7555463314056396
1157,sql_generation,1,865,109,974,1756883811.5272632,1756883813.1055431,1.578279972076416
1158,sql_execution,1,0,0,0,1756883813.1064215,1756883813.1407094,0.03428792953491211
1159,rephrase_question,1,0,0,0,1756883925.6460714,1756883925.6461868,0.00011539459228515625
1160,intent_identification,1,731,68,799,1756883925.6466265,1756883926.9253466,1.2787201404571533
1161,column_identification,1,1072,110,1182,1756883926.9259923,1756883928.5108528,1.5848605632781982
1162,sql_generation,1,865,106,971,1756883928.5180302,1756883930.124026,1.6059958934783936
1163,sql_execution,1,0,0,0,1756883930.1247816,1756883930.1641867,0.039405107498168945
1164,rephrase_question,1,0,0,0,1756992438.1077993,1756992438.1107955,0.002996206283569336
1165,intent_identification,1,735,79,814,1756992438.1107955,1756992441.006683,2.895887613296509
1166,column_identification,1,1076,115,1191,1756992441.006683,1756992442.7956254,1.7889423370361328
1167,sql_generation,1,1180,95,1275,1756992442.8011587,1756992444.4956846,1.694525957107544
1168,sql_execution,1,0,0,0,1756992444.4956846,1756992445.1259577,0.6302731037139893
1169,rephrase_question,1,0,0,0,1756992700.675647,1756992700.675647,0.0
1170,intent_identification,1,735,69,804,1756992700.675647,1756992702.456852,1.7812049388885498
1171,column_identification,1,1077,112,1189,1756992702.456852,1756992704.2567968,1.7999448776245117
1172,sql_generation,1,1181,75,1256,1756992704.2597318,1756992705.535589,1.2758572101593018
1173,sql_execution,1,0,0,0,1756992705.5512943,1756992705.9566047,0.40531039237976074
1174,rephrase_question,1,0,0,0,1756993501.0629833,1756993501.0657623,0.0027790069580078125
1175,intent_identification,1,735,69,804,1756993501.0657623,1756993502.8067057,1.740943431854248
1176,column_identification,1,1077,116,1193,1756993502.8067057,1756993504.612825,1.8061192035675049
1177,sql_generation,1,1181,86,1267,1756993504.62915,1756993506.280362,1.6512119770050049
1178,sql_execution,1,0,0,0,1756993506.280362,1756993508.260171,1.979809045791626
1179,rephrase_question,1,0,0,0,1757061279.5204818,1757061279.5204818,0.0
1180,intent_identification,1,735,80,815,1757061279.5204818,1757061282.8534307,3.332948923110962
1181,column_identification,1,1077,116,1193,1757061282.8534307,1757061284.70149,1.8480591773986816
1182,sql_generation,1,1181,75,1256,1757061284.7052984,1757061286.0388029,1.3335044384002686
1183,sql_execution,1,0,0,0,1757061286.0388029,1757061287.3549654,1.3161625862121582
1184,rephrase_question,1,0,0,0,1757073716.8149335,1757073716.821662,0.006728410720825195
1185,intent_identification,1,735,79,814,1757073716.8225925,1757073720.0237362,3.201143741607666
1186,column_identification,1,1076,111,1187,1757073720.0237362,1757073721.7862182,1.762481927871704
1187,sql_generation,1,1180,55,1235,1757073721.7862182,1757073723.768004,1.981785774230957
1188,sql_execution,1,0,0,0,1757073723.768004,1757073724.2988946,0.530890703201294
1189,rephrase_question,1,0,0,0,1757073752.928285,1757073752.928285,0.0
1190,intent_identification,1,738,80,818,1757073752.928285,1757073754.2944176,1.3661327362060547
1191,column_identification,1,1081,115,1196,1757073754.2944176,1757073756.1253016,1.8308839797973633
1192,sql_generation,1,1185,141,1326,1757073756.1260674,1757073758.085821,1.9597535133361816
1193,sql_execution,1,0,0,0,1757073758.0867715,1757073758.3505275,0.26375603675842285
1194,rephrase_question,1,0,0,0,1757073815.9755697,1757073815.9755697,0.0
1195,intent_identification,1,738,69,807,1757073815.9755697,1757073817.326157,1.3505873680114746
1196,column_identification,1,1081,115,1196,1757073817.326157,1757073819.3893743,2.0632171630859375
1197,sql_generation,1,1185,126,1311,1757073819.390827,1757073821.1973798,1.8065528869628906
1198,sql_execution,1,0,0,0,1757073821.2024362,1757073821.487024,0.2845878601074219
1199,rephrase_question,1,0,0,0,1757074049.8190591,1757074049.820118,0.001058816909790039
1200,intent_identification,1,739,80,819,1757074049.8211331,1757074051.5875943,1.7664611339569092
1201,column_identification,1,1082,115,1197,1757074051.5875943,1757074053.3340113,1.7464170455932617
1202,sql_generation,1,1186,142,1328,1757074053.3340113,1757074055.221185,1.8871736526489258
1203,sql_execution,1,0,0,0,1757074055.2221794,1757074055.8607802,0.6386008262634277
1204,rephrase_question,1,0,0,0,1757074160.2406075,1757074160.2406075,0.0
1205,intent_identification,1,736,69,805,1757074160.2406075,1757074161.5596611,1.3190536499023438
1206,column_identification,1,1079,115,1194,1757074161.5596611,1757074163.59281,2.033148765563965
1207,sql_generation,1,1183,135,1318,1757074163.59281,1757074165.422901,1.8300909996032715
1208,sql_execution,1,0,0,0,1757074165.422901,1757074165.704488,0.2815871238708496
1209,rephrase_question,1,0,0,0,1757164423.5752118,1757164423.5752118,0.0
1210,intent_identification,1,736,69,805,1757164423.5752118,1757164426.7612274,3.1860156059265137
1211,column_identification,1,1079,115,1194,1757164426.7612274,1757164428.7108023,1.9495749473571777
1212,sql_generation,1,1183,118,1301,1757164428.7108023,1757164431.1850884,2.4742860794067383
1213,sql_execution,1,0,0,0,1757164431.1850884,1757164432.0373695,0.8522810935974121
1214,rephrase_question,1,0,0,0,1757164503.09006,1757164503.09006,0.0
1215,intent_identification,1,738,69,807,1757164503.09006,1757164504.4738617,1.3838016986846924
1216,column_identification,1,1081,115,1196,1757164504.4738617,1757164506.4071887,1.9333269596099854
1217,sql_generation,1,1185,74,1259,1757164506.4071887,1757164508.4514403,2.0442516803741455
1218,sql_execution,1,0,0,0,1757164508.4514403,1757164508.5534587,0.10201835632324219
1219,rephrase_question,1,0,0,0,1757164576.6783066,1757164576.6783066,0.0
1220,intent_identification,1,738,80,818,1757164576.6783066,1757164578.2960637,1.6177570819854736
1221,column_identification,1,1081,115,1196,1757164578.2960637,1757164580.0805757,1.7845120429992676
1222,sql_generation,1,1185,115,1300,1757164580.0805757,1757164584.582138,4.5015623569488525
1223,sql_execution,1,0,0,0,1757164584.582138,1757164584.822596,0.24045801162719727
1224,rephrase_question,1,0,0,0,1757165747.1690595,1757165747.1803384,0.011278867721557617
1225,intent_identification,1,738,80,818,1757165747.1803384,1757165749.0318618,1.8515233993530273
1226,column_identification,1,1081,115,1196,1757165749.0318618,1757165750.7680912,1.736229419708252
1227,sql_generation,1,1223,130,1353,1757165750.7680912,1757165753.5308774,2.7627861499786377
1228,sql_execution,1,0,0,0,1757165753.5381358,1757165756.29382,2.7556841373443604
1229,rephrase_question,1,0,0,0,1757165922.783272,1757165922.783272,0.0
1230,intent_identification,1,739,69,808,1757165922.783272,1757165924.1448474,1.3615753650665283
1231,column_identification,1,1082,119,1201,1757165924.1448474,1757165925.8963187,1.7514712810516357
1232,sql_generation,1,1224,129,1353,1757165925.8999825,1757165928.393692,2.4937095642089844
1233,sql_execution,1,0,0,0,1757165928.393692,1757165928.6897802,0.29608821868896484
1234,rephrase_question,1,0,0,0,1757165972.3555624,1757165972.3555624,0.0
1235,intent_identification,1,740,80,820,1757165972.3555624,1757165973.8968065,1.5412440299987793
1236,column_identification,1,1083,115,1198,1757165973.8968065,1757165975.594067,1.6972606182098389
1237,sql_generation,1,1225,136,1361,1757165975.594067,1757165978.0260673,2.432000160217285
1238,sql_execution,1,0,0,0,1757165978.0260673,1757165978.3347595,0.30869221687316895
1239,rephrase_question,1,0,0,0,1757166074.4521444,1757166074.4521444,0.0
1240,intent_identification,1,740,80,820,1757166074.4521444,1757166075.7974591,1.3453147411346436
1241,column_identification,1,1083,115,1198,1757166075.7974591,1757166077.5281086,1.730649471282959
1242,sql_generation,1,1225,165,1390,1757166077.5305629,1757166080.192604,2.662041187286377
1243,sql_execution,1,0,0,0,1757166080.192604,1757166080.6971445,0.5045404434204102
1244,rephrase_question,1,0,0,0,1757166121.9498615,1757166121.9498615,0.0
1245,intent_identification,1,739,69,808,1757166121.9498615,1757166123.30166,1.3517985343933105
1246,column_identification,1,1082,115,1197,1757166123.30166,1757166125.7921677,2.4905076026916504
1247,sql_generation,1,1224,118,1342,1757166125.7921677,1757166128.2086492,2.4164814949035645
1248,sql_execution,1,0,0,0,1757166128.2086492,1757166128.661449,0.45279979705810547
1249,rephrase_question,1,0,0,0,1757166376.1685498,1757166376.1685498,0.0
1250,intent_identification,1,738,80,818,1757166376.1685498,1757166378.2118032,2.0432534217834473
1251,column_identification,1,1081,115,1196,1757166378.2118032,1757166379.9146926,1.7028894424438477
1252,sql_generation,1,1326,149,1475,1757166379.9146926,1757166382.4794834,2.564790725708008
1253,sql_execution,1,0,0,0,1757166382.4794834,1757166385.341733,2.8622496128082275
1254,rephrase_question,1,0,0,0,1757166395.6829174,1757166395.6829174,0.0
1255,intent_identification,1,738,69,807,1757166395.6910396,1757166397.1161036,1.4250640869140625
1256,column_identification,1,1081,115,1196,1757166397.1161036,1757166398.962977,1.8468732833862305
1257,sql_generation,1,1326,157,1483,1757166398.962977,1757166401.9633706,3.0003936290740967
1258,sql_execution,1,0,0,0,1757166401.9688082,1757166402.277454,0.30864572525024414
1259,rephrase_question,1,0,0,0,1757166411.2009194,1757166411.2009194,0.0
1260,intent_identification,1,739,69,808,1757166411.2009194,1757166412.6807253,1.4798059463500977
1261,column_identification,1,1082,115,1197,1757166412.6807253,1757166414.524197,1.8434717655181885
1262,sql_generation,1,1327,157,1484,1757166414.524197,1757166417.317252,2.7930548191070557
1263,sql_execution,1,0,0,0,1757166417.318104,1757166417.6092257,0.2911217212677002
1264,rephrase_question,1,0,0,0,1757306495.7696435,1757306495.7704926,0.0008490085601806641
1265,intent_identification,1,743,47,790,1757306495.7704926,1757306498.3628616,2.5923690795898438
1266,column_identification,1,1063,87,1150,1757306498.3628616,1757306499.772486,1.4096243381500244
1267,sql_generation,1,1279,117,1396,1757306499.772486,1757306502.9218216,3.1493356227874756
1268,sql_execution,1,0,0,0,1757306502.9218216,1757306503.7307754,0.8089537620544434
1269,rephrase_question,1,0,0,0,1757307896.790859,1757307896.790859,0.0
1270,intent_identification,1,743,57,800,1757307896.790859,1757307898.1900375,1.3991785049438477
1271,column_identification,1,1063,87,1150,1757307898.1900375,1757307899.6221101,1.432072639465332
1272,sql_generation,1,1279,116,1395,1757307899.6221101,1757307902.1380906,2.5159804821014404
1273,sql_execution,1,0,0,0,1757307902.1380906,1757307902.57097,0.4328794479370117
1274,rephrase_question,1,0,0,0,1757326606.554639,1757326606.554639,0.0
1275,intent_identification,1,739,84,823,1757326606.554639,1757326608.868358,2.313718795776367
1276,column_identification,1,1084,123,1207,1757326608.868358,1757326610.951508,2.0831501483917236
1277,sql_generation,1,1329,170,1499,1757326610.951508,1757326615.1640146,4.212506532669067
1278,sql_execution,1,0,0,0,1757326615.1640146,1757326615.7713287,0.6073141098022461
1279,rephrase_question,1,0,0,0,1757394720.8027494,1757394720.8027494,0.0
1280,intent_identification,1,739,72,811,1757394720.8027494,1757394736.5754938,15.772744417190552
1281,column_identification,1,1084,123,1207,1757394736.5754938,1757394741.7530618,5.177567958831787
1282,sql_generation,1,1329,165,1494,1757394741.7530618,1757394749.803388,8.050326347351074
1283,sql_execution,1,0,0,0,1757394749.8044076,1757394750.413468,0.6090602874755859
1284,rephrase_question,1,0,0,0,1757395688.0868163,1757395688.0868163,0.0
1285,intent_identification,1,735,80,815,1757395688.0868163,1757395690.7218306,2.635014295578003
1286,column_identification,1,1077,116,1193,1757395690.7218306,1757395692.4277508,1.7059202194213867
1287,sql_generation,1,1322,75,1397,1757395692.4317489,1757395694.4288774,1.9971284866333008
1288,sql_execution,1,0,0,0,1757395694.4304788,1757395694.5238075,0.09332871437072754
1289,rephrase_question,1,0,0,0,1757396115.8069782,1757396115.8089752,0.0019969940185546875
1290,intent_identification,1,735,69,804,1757396115.809971,1757396120.378731,4.568759918212891
1291,column_identification,1,1077,116,1193,1757396120.378731,1757396128.33611,7.957379102706909
1292,sql_generation,1,1322,91,1413,1757396128.3519325,1757396139.1991057,10.84717321395874
1293,sql_execution,1,0,0,0,1757396139.1991057,1757396139.7737896,0.5746839046478271
1294,rephrase_question,1,0,0,0,1757399442.6867368,1757399442.6897087,0.0029718875885009766
1295,intent_identification,1,735,68,803,1757399442.6897087,1757399451.1955957,8.505887031555176
1296,column_identification,1,1076,115,1191,1757399451.1955957,1757399454.1314619,2.935866117477417
1297,sql_generation,1,1321,103,1424,1757399454.1406877,1757399462.5697072,8.429019451141357
1298,sql_execution,1,0,0,0,1757399462.5697072,1757399463.1260107,0.5563035011291504
1299,rephrase_question,1,0,0,0,1757402022.2517877,1757402022.2517877,0.0
1300,intent_identification,1,735,68,803,1757402022.2517877,1757402025.0821965,2.830408811569214
1301,column_identification,1,1076,111,1187,1757402025.0821965,1757402026.7390547,1.656858205795288
1302,sql_generation,1,1321,103,1424,1757402026.7390547,1757402029.019979,2.2809243202209473
1303,sql_execution,1,0,0,0,1757402029.0208948,1757402029.5427685,0.5218737125396729
1304,rephrase_question,1,0,0,0,1757402130.0793984,1757402130.0793984,0.0
1305,intent_identification,1,739,72,811,1757402130.0793984,1757402131.4488401,1.3694417476654053
1306,column_identification,1,1084,123,1207,1757402131.4488401,1757402133.2368925,1.7880523204803467
1307,sql_generation,1,1329,98,1427,1757402133.2379327,1757402135.5257983,2.28786563873291
1308,sql_execution,1,0,0,0,1757402135.5257983,1757402135.686179,0.16038060188293457
1309,rephrase_question,1,0,0,0,1757403776.592898,1757403776.592898,0.0
1310,intent_identification,1,740,75,815,1757403776.592898,1757403779.6577866,3.0648887157440186
1311,column_identification,1,1088,133,1221,1757403779.6577866,1757403781.6752024,2.017415761947632
1312,sql_generation,1,1159,76,1235,1757403781.6752024,1757403783.622209,1.9470067024230957
1313,sql_execution,1,0,0,0,1757403783.622209,1757403784.192301,0.570091962814331
1314,rephrase_question,1,0,0,0,1757403862.814603,1757403862.814603,0.0
1315,intent_identification,1,735,69,804,1757403862.814603,1757403864.0891156,1.274512529373169
1316,column_identification,1,1077,116,1193,1757403864.0891156,1757403865.7886028,1.6994872093200684
1317,sql_generation,1,1143,62,1205,1757403865.7917638,1757403867.5021276,1.7103638648986816
1318,sql_execution,1,0,0,0,1757403867.5021276,1757403867.599151,0.09702324867248535
1319,rephrase_question,1,0,0,0,1757404047.9372058,1757404047.9372058,0.0
1320,intent_identification,1,735,79,814,1757404047.9372058,1757404050.8871539,2.9499480724334717
1321,column_identification,1,1076,115,1191,1757404050.8871539,1757404052.5652435,1.6780896186828613
1322,sql_generation,1,1222,62,1284,1757404052.5824335,1757404054.575994,1.993560552597046
1323,sql_execution,1,0,0,0,1757404054.575994,1757404055.0130932,0.4370992183685303
1324,rephrase_question,1,0,0,0,1757409748.7349083,1757409748.7465482,0.011639833450317383
1325,intent_identification,1,736,79,815,1757409748.7465482,1757409751.5727305,2.8261823654174805
1326,column_identification,1,1077,110,1187,1757409751.5727305,1757409753.2866344,1.7139039039611816
1327,sql_generation,1,1139,105,1244,1757409753.292482,1757409756.3789253,3.0864434242248535
1328,sql_execution,1,0,0,0,1757409756.3789253,1757409756.799821,0.4208955764770508
1329,rephrase_question,1,0,0,0,1757409823.360984,1757409823.360984,0.0
1330,intent_identification,1,737,68,805,1757409823.360984,1757409824.8255737,1.4645895957946777
1331,column_identification,1,1078,115,1193,1757409824.8255737,1757409826.5782297,1.7526559829711914
1332,sql_generation,1,1144,104,1248,1757409826.5782297,1757409829.7188404,3.140610694885254
1333,sql_execution,1,0,0,0,1757409829.7188404,1757409829.8382337,0.11939334869384766
1334,rephrase_question,1,0,0,0,1757409868.4597526,1757409868.481272,0.02151942253112793
1335,intent_identification,1,737,73,810,1757409868.481272,1757409872.239107,3.7578349113464355
1336,column_identification,1,1083,122,1205,1757409872.239107,1757409882.363075,10.123968124389648
1337,sql_generation,1,1148,116,1264,1757409882.3760264,1757409885.5650332,3.189006805419922
1338,sql_execution,1,0,0,0,1757409885.5650332,1757409885.6550303,0.0899970531463623
1339,rephrase_question,1,0,0,0,1757409902.1146827,1757409902.1146827,0.0
1340,intent_identification,1,737,79,816,1757409902.1146827,1757409903.809342,1.6946592330932617
1341,column_identification,1,1078,120,1198,1757409903.809342,1757409906.1741834,2.3648414611816406
1342,sql_generation,1,1148,121,1269,1757409906.1791806,1757409909.6352782,3.4560976028442383
1343,sql_execution,1,0,0,0,1757409909.6352782,1757409909.7389894,0.10371112823486328
1344,rephrase_question,1,0,0,0,1757410466.3486607,1757410466.3486607,0.0
1345,intent_identification,1,737,68,805,1757410466.3486607,1757410468.950317,2.601656198501587
1346,column_identification,1,1078,110,1188,1757410468.950317,1757410470.7996516,1.849334716796875
1347,sql_generation,1,1140,168,1308,1757410470.8094618,1757410477.220854,6.4113922119140625
1348,sql_execution,1,0,0,0,1757410477.220854,1757410477.3077574,0.08690333366394043
1349,rephrase_question,1,0,0,0,1757410511.160225,1757410511.160225,0.0
1350,intent_identification,1,735,69,804,1757410511.160225,1757410515.2620475,4.1018226146698
1351,column_identification,1,1077,116,1193,1757410515.2620475,1757410518.4965866,3.234539031982422
1352,sql_generation,1,1143,64,1207,1757410518.5024023,1757410525.9558306,7.453428268432617
1353,sql_execution,1,0,0,0,1757410525.9656224,1757410526.0537524,0.08812999725341797
1354,rephrase_question,1,0,0,0,1757411209.6402698,1757411209.6402698,0.0
1355,intent_identification,1,735,68,803,1757411209.6402698,1757411211.4456053,1.805335521697998
1356,column_identification,1,1076,115,1191,1757411211.4456053,1757411213.3441415,1.898536205291748
1357,sql_generation,1,1142,92,1234,1757411213.3722022,1757411215.6540375,2.2818353176116943
1358,sql_execution,1,0,0,0,1757411215.6540375,1757411216.188767,0.5347294807434082
1359,rephrase_question,1,0,0,0,1757415269.878471,1757415269.8852413,0.00677037239074707
1360,intent_identification,1,739,79,818,1757415269.8852413,1757415273.0692506,3.184009313583374
1361,column_identification,1,1080,115,1195,1757415273.0692506,1757415275.0821042,2.0128536224365234
1362,sql_generation,1,1146,110,1256,1757415275.104658,1757415278.3432734,3.2386155128479004
1363,sql_execution,1,0,0,0,1757415278.3432734,1757415279.865418,1.5221445560455322
1364,rephrase_question,1,0,0,0,1757418700.7386572,1757418700.7386572,0.0
1365,intent_identification,1,735,68,803,1757418700.748566,1757418703.7343018,2.9857358932495117
1366,column_identification,1,1076,115,1191,1757418703.7343018,1757418705.5654593,1.8311574459075928
1367,sql_generation,1,1189,89,1278,1757418705.5734894,1757418707.9283438,2.3548543453216553
1368,sql_execution,1,0,0,0,1757418707.9283438,1757418710.078113,2.1497693061828613
1369,rephrase_question,1,0,0,0,1757418793.0851457,1757418793.0851457,0.0
1370,intent_identification,1,736,68,804,1757418793.0851457,1757418794.430846,1.3457002639770508
1371,column_identification,1,1077,115,1192,1757418794.430846,1757418796.1433883,1.7125422954559326
1372,sql_generation,1,1190,95,1285,1757418796.1606457,1757418799.7817662,3.6211204528808594
1373,sql_execution,1,0,0,0,1757418799.7833624,1757418800.1271548,0.3437924385070801
1374,rephrase_question,1,0,0,0,1757418842.550707,1757418842.550707,0.0
1375,intent_identification,1,735,68,803,1757418842.550707,1757418844.01272,1.4620130062103271
1376,column_identification,1,1076,115,1191,1757418844.01272,1757418845.8555274,1.8428072929382324
1377,sql_generation,1,1189,102,1291,1757418845.8663192,1757418849.6298892,3.7635700702667236
1378,sql_execution,1,0,0,0,1757418849.6298892,1757418849.7447693,0.11488008499145508
1379,rephrase_question,1,0,0,0,1757418877.313129,1757418877.313129,0.0
1380,intent_identification,1,735,80,815,1757418877.313129,1757418878.8226888,1.5095598697662354
1381,column_identification,1,1077,99,1176,1757418878.8226888,1757418880.4717104,1.6490216255187988
1382,sql_generation,1,1179,64,1243,1757418880.4783766,1757418882.3099496,1.8315730094909668
1383,sql_execution,1,0,0,0,1757418882.3099496,1757418882.6405098,0.33056020736694336
1384,rephrase_question,1,0,0,0,1757420764.978601,1757420764.9795613,0.0009603500366210938
1385,intent_identification,1,739,68,807,1757420764.9795613,1757420766.701106,1.7215447425842285
1386,column_identification,1,1081,115,1196,1757420766.701106,1757420768.4181619,1.7170557975769043
1387,sql_generation,1,1195,205,1400,1757420768.4340353,1757420772.419451,3.9854156970977783
1388,sql_execution,1,0,0,0,1757420772.4203956,1757420773.002739,0.582343339920044
1389,rephrase_question,1,0,0,0,1757420833.9917836,1757420833.9917836,0.0
1390,intent_identification,1,735,68,803,1757420833.9927814,1757420835.2140453,1.2212638854980469
1391,column_identification,1,1077,115,1192,1757420835.2140453,1757420836.9619133,1.7478680610656738
1392,sql_generation,1,1191,64,1255,1757420836.9619133,1757420838.689412,1.7274987697601318
1393,sql_execution,1,0,0,0,1757420838.689412,1757420838.7858484,0.0964362621307373
1394,rephrase_question,1,0,0,0,1757420891.9028618,1757420891.9028618,0.0
1395,intent_identification,1,734,81,815,1757420891.9028618,1757420893.3910346,1.4881727695465088
1396,column_identification,1,1078,100,1178,1757420893.3910346,1757420895.5831418,2.1921072006225586
1397,sql_generation,1,1181,62,1243,1757420895.598903,1757420897.3381174,1.7392144203186035
1398,sql_execution,1,0,0,0,1757420897.3393216,1757420897.4221084,0.08278679847717285
1399,rephrase_question,1,0,0,0,1757421397.3871872,1757421397.3871872,0.0
1400,intent_identification,1,735,68,803,1757421397.3871872,1757421399.0357947,1.6486074924468994
1401,column_identification,1,1077,111,1188,1757421399.0357947,1757421400.8455904,1.809795618057251
1402,sql_generation,1,1143,96,1239,1757421400.8496842,1757421402.9686358,2.1189515590667725
1403,sql_execution,1,0,0,0,1757421402.9686358,1757421403.510033,0.5413970947265625
1404,rephrase_question,1,0,0,0,1757422637.9432657,1757422637.9432657,0.0
1405,intent_identification,1,735,68,803,1757422637.9432657,1757422640.87969,2.9364242553710938
1406,column_identification,1,1077,115,1192,1757422640.87969,1757422642.6814828,1.801792860031128
1407,sql_generation,1,1143,64,1207,1757422642.6814828,1757422644.5296476,1.8481647968292236
1408,sql_execution,1,0,0,0,1757422644.5296476,1757422645.0335767,0.5039291381835938
1409,rephrase_question,1,0,0,0,1757424477.0427523,1757424477.0427523,0.0
1410,intent_identification,1,735,79,814,1757424477.0427523,1757424478.7800195,1.737267255783081
1411,column_identification,1,1077,115,1192,1757424478.7800195,1757424480.6154692,1.8354496955871582
1412,sql_generation,1,1143,64,1207,1757424480.6184351,1757424482.9808261,2.3623909950256348
1413,sql_execution,1,0,0,0,1757424482.9808261,1757424483.5114772,0.5306510925292969
1414,rephrase_question,1,0,0,0,1757425581.7169425,1757425581.7169425,0.0
1415,intent_identification,1,735,69,804,1757425581.7169425,1757425589.4943314,7.77738881111145
1416,column_identification,1,1078,116,1194,1757425589.4943314,1757425592.3571353,2.8628039360046387
1417,sql_generation,1,1143,49,1192,1757425592.362272,1757425594.1968777,1.8346056938171387
1418,sql_execution,1,0,0,0,1757425594.1968777,1757425594.7157338,0.5188560485839844
1419,rephrase_question,1,0,0,0,1757425617.6871192,1757425617.6871192,0.0
1420,intent_identification,1,735,68,803,1757425617.6871192,1757425619.4620166,1.7748973369598389
1421,column_identification,1,1077,115,1192,1757425619.4620166,1757425621.3025014,1.840484857559204
1422,sql_generation,1,1143,62,1205,1757425621.317703,1757425623.2501385,1.9324355125427246
1423,sql_execution,1,0,0,0,1757425623.2647846,1757425623.3496969,0.08491230010986328
1424,rephrase_question,1,0,0,0,1757425841.9918432,1757425841.9918432,0.0
1425,intent_identification,1,739,72,811,1757425841.9918432,1757425843.8011374,1.8092942237854004
1426,column_identification,1,1084,123,1207,1757425843.8011374,1757425845.7004132,1.899275779724121
1427,sql_generation,1,1150,151,1301,1757425845.7004132,1757425848.4860618,2.7856485843658447
1428,sql_execution,1,0,0,0,1757425848.4860618,1757425848.9707873,0.4847254753112793
1429,rephrase_question,1,0,0,0,1757488954.936757,1757488954.9526408,0.015883684158325195
1430,intent_identification,1,741,78,819,1757488954.9526408,1757488957.949305,2.99666428565979
1431,column_identification,1,1081,125,1206,1757488957.949305,1757488962.2053895,4.256084442138672
1432,sql_generation,1,1155,134,1289,1757488962.2192383,1757488966.1359842,3.916745901107788
1433,sql_execution,1,0,0,0,1757488966.1359842,1757488966.8375814,0.7015972137451172
1434,rephrase_question,1,0,0,0,1757489614.3111389,1757489614.3278122,0.01667332649230957
1435,intent_identification,1,731,85,816,1757489614.3278122,1757489615.9001694,1.572357177734375
1436,column_identification,1,1078,110,1188,1757489615.9011958,1757489617.9252725,2.0240767002105713
1437,sql_generation,1,1135,106,1241,1757489617.930574,1757489620.6056874,2.6751134395599365
1438,sql_execution,1,0,0,0,1757489620.6071615,1757489620.7447252,0.13756370544433594
1439,rephrase_question,1,0,0,0,1757491437.9668057,1757491437.9668057,0.0
1440,intent_identification,1,731,68,799,1757491437.9668057,1757491440.667878,2.7010722160339355
1441,column_identification,1,1073,106,1179,1757491440.667878,1757491442.455172,1.7872941493988037
1442,sql_generation,1,1135,105,1240,1757491442.455172,1757491445.2838116,2.828639507293701
1443,sql_execution,1,0,0,0,1757491445.2838116,1757491445.3826485,0.09883689880371094
1444,rephrase_question,1,0,0,0,1757492177.6330209,1757492177.6349766,0.001955747604370117
1445,intent_identification,1,731,89,820,1757492177.6349766,1757492180.6362884,3.001311779022217
1446,column_identification,1,1094,144,1238,1757492180.6362884,1757492182.732717,2.096428632736206
1447,sql_generation,1,1185,148,1333,1757492182.7485738,1757492185.3381157,2.5895419120788574
1448,sql_execution,1,0,0,0,1757492185.339158,1757492185.875335,0.5361769199371338
1449,rephrase_question,1,0,0,0,1757492256.203409,1757492256.2044106,0.001001596450805664
1450,intent_identification,1,739,72,811,1757492256.2044106,1757492257.579113,1.3747024536132812
1451,column_identification,1,1084,128,1212,1757492257.579113,1757492259.5707233,1.9916102886199951
1452,sql_generation,1,1154,126,1280,1757492259.5707233,1757492261.9698853,2.3991620540618896
1453,sql_execution,1,0,0,0,1757492261.9698853,1757492262.1093466,0.13946127891540527
1454,rephrase_question,1,0,0,0,1757500727.884659,1757500727.8866644,0.002005338668823242
1455,intent_identification,1,739,72,811,1757500727.8866644,1757500731.5699825,3.6833181381225586
1456,column_identification,1,1084,123,1207,1757500731.5699825,1757500733.5963905,2.0264079570770264
1457,sql_generation,1,1150,102,1252,1757500733.5973833,1757500735.6721213,2.074738025665283
1458,sql_execution,1,0,0,0,1757500735.6731632,1757500736.3194776,0.6463143825531006
1459,rephrase_question,1,0,0,0,1757500936.3432577,1757500936.3432577,0.0
1460,intent_identification,1,731,84,815,1757500936.3432577,1757500938.100534,1.7572762966156006
1461,column_identification,1,1077,111,1188,1757500938.100534,1757500939.851042,1.7505080699920654
1462,sql_generation,1,1135,121,1256,1757500939.851042,1757500942.530886,2.6798439025878906
1463,sql_execution,1,0,0,0,1757500942.53317,1757500942.620956,0.08778595924377441
1464,rephrase_question,1,0,0,0,1757502186.9412491,1757502186.9412491,0.0
1465,intent_identification,1,731,69,800,1757502186.9412491,1757502189.6879892,2.7467401027679443
1466,column_identification,1,1130,112,1242,1757502189.6879892,1757502191.3708842,1.6828949451446533
1467,sql_generation,1,1139,106,1245,1757502191.3783848,1757502194.2800667,2.901681900024414
1468,sql_execution,1,0,0,0,1757502194.2820652,1757502194.843711,0.5616457462310791
1469,rephrase_question,1,0,0,0,1757502397.0156457,1757502397.0156457,0.0
1470,intent_identification,1,698,88,786,1757502397.0156457,1757502400.2493193,3.233673572540283
1471,column_identification,1,1137,118,1255,1757502400.2493193,1757502402.3550553,2.105736017227173
1472,sql_generation,1,1139,107,1246,1757502402.3550553,1757502404.5610547,2.2059993743896484
1473,sql_execution,1,0,0,0,1757502404.5620494,1757502404.969262,0.407212495803833
1474,rephrase_question,1,0,0,0,1757505506.428234,1757505506.4441633,0.015929222106933594
1475,intent_identification,1,698,74,772,1757505506.4441633,1757505509.1334622,2.6892988681793213
1476,column_identification,1,1123,104,1227,1757505509.1334622,1757505510.6673124,1.5338501930236816
1477,sql_generation,1,1139,97,1236,1757505510.6770642,1757505512.8609776,2.183913469314575
1478,sql_execution,1,0,0,0,1757505512.8609776,1757505513.4189055,0.5579278469085693
